Iter 0: InceptionV4/InceptionV4/Conv2d_1a_3x3/Conv2D	Convolution	CPU	18058	541	18599
Iter 1: InceptionV4/InceptionV4/Conv2d_2a_3x3/Conv2D	Convolution	CPU	29869	18771	48640
Iter 2: InceptionV4/InceptionV4/Conv2d_2b_3x3/Conv2D	Convolution	CPU	45417	48824	94241
Iter 3: InceptionV4/InceptionV4/Mixed_3a/Branch_0/MaxPool_0a_3x3/MaxPool	Pooling	CPU	4932	96185	101117
Iter 4: InceptionV4/InceptionV4/Mixed_3a/Branch_1/Conv2d_0a_3x3/Conv2D	Convolution	CPU	85773	101543	187316
Iter 5: InceptionV4/InceptionV4/Mixed_3a/concat	Concat	CPU	6397	187786	194183
Iter 6: InceptionV4/InceptionV4/Mixed_4a/Branch_1/Conv2d_0a_1x1/Conv2D	Convolution	CPU	13520	194381	207901
Iter 7: InceptionV4/InceptionV4/Mixed_4a/Branch_0/Conv2d_0a_1x1/Conv2D	Convolution	OpenCL	31880	194473	226353
Iter 8: InceptionV4/InceptionV4/Mixed_4a/Branch_0/Conv2d_1a_3x3/Conv2D	Convolution	OpenCL	25651	226489	252140
Iter 9: InceptionV4/InceptionV4/Mixed_4a/Branch_1/Conv2d_0b_1x7/Conv2D	Convolution	CPU	44274	208173	252447
Iter 10: InceptionV4/InceptionV4/Mixed_4a/Branch_1/Conv2d_0c_7x1/Conv2D	Convolution	CPU	30683	252781	283464
Iter 11: InceptionV4/InceptionV4/Mixed_4a/Branch_1/Conv2d_1a_3x3/Conv2D	Convolution	CPU	17178	283674	300852
Iter 12: InceptionV4/InceptionV4/Mixed_4a/concat	Concat	CPU	3229	300999	304228
Iter 13: InceptionV4/InceptionV4/Mixed_5a/Branch_0/Conv2d_1a_3x3/Conv2D	Convolution	CPU	76764	304285	381049
Iter 14: InceptionV4/InceptionV4/Mixed_5a/Branch_1/MaxPool_1a_3x3/MaxPool	Pooling	CPU	2296	381210	383506
Iter 15: InceptionV4/InceptionV4/Mixed_5a/concat	Concat	CPU	1152	383621	384773
Iter 16: InceptionV4/InceptionV4/Mixed_5b/Branch_0/Conv2d_0a_1x1/Conv2D	Convolution	CPU	7467	384832	392299
Iter 17: InceptionV4/InceptionV4/Mixed_5b/Branch_1/Conv2d_0a_1x1/Conv2D	Convolution	OpenCL	10162	384902	395064
Iter 18: InceptionV4/InceptionV4/Mixed_5b/Branch_2/Conv2d_0a_1x1/Conv2D	Convolution	CPU	5090	392467	397557
Iter 19: InceptionV4/InceptionV4/Mixed_5b/Branch_2/Conv2d_0b_3x3/Conv2D	Convolution	CPU	5439	397704	403143
Iter 20: InceptionV4/InceptionV4/Mixed_5b/Branch_1/Conv2d_0b_3x3/Conv2D	Convolution	OpenCL	9028	395164	404192
Iter 21: InceptionV4/InceptionV4/Mixed_5b/Branch_2/Conv2d_0c_3x3/Conv2D	Convolution	CPU	5950	403280	409230
Iter 22: InceptionV4/InceptionV4/Mixed_5b/Branch_3/AvgPool_0a_3x3/AvgPool	Pooling	CPU	1892	409456	411348
Iter 23: InceptionV4/InceptionV4/Mixed_5b/Branch_3/Conv2d_0b_1x1/Conv2D	Convolution	CPU	3843	411469	415312
Iter 24: InceptionV4/InceptionV4/Mixed_5b/concat	Concat	CPU	1596	415437	417033
Iter 25: InceptionV4/InceptionV4/Mixed_5c/Branch_0/Conv2d_0a_1x1/Conv2D	Convolution	CPU	4021	417113	421134
Iter 26: InceptionV4/InceptionV4/Mixed_5c/Branch_3/AvgPool_0a_3x3/AvgPool	Pooling	OpenCL	6300	417222	423522
Iter 27: InceptionV4/InceptionV4/Mixed_5c/Branch_1/Conv2d_0a_1x1/Conv2D	Convolution	CPU	2964	421299	424263
Iter 28: InceptionV4/InceptionV4/Mixed_5c/Branch_1/Conv2d_0b_3x3/Conv2D	Convolution	CPU	4225	424353	428578
Iter 29: InceptionV4/InceptionV4/Mixed_5c/Branch_3/Conv2d_0b_1x1/Conv2D	Convolution	OpenCL	6380	423711	430091
Iter 30: InceptionV4/InceptionV4/Mixed_5c/Branch_2/Conv2d_0a_1x1/Conv2D	Convolution	CPU	2781	428708	431489
Iter 31: InceptionV4/InceptionV4/Mixed_5c/Branch_2/Conv2d_0b_3x3/Conv2D	Convolution	CPU	3784	431580	435364
Iter 32: InceptionV4/InceptionV4/Mixed_5c/Branch_2/Conv2d_0c_3x3/Conv2D	Convolution	CPU	5683	435506	441189
Iter 33: InceptionV4/InceptionV4/Mixed_5c/concat	Concat	CPU	1523	441396	442919
Iter 34: InceptionV4/InceptionV4/Mixed_5d/Branch_0/Conv2d_0a_1x1/Conv2D	Convolution	CPU	4138	442981	447119
Iter 35: InceptionV4/InceptionV4/Mixed_5d/Branch_3/AvgPool_0a_3x3/AvgPool	Pooling	OpenCL	6146	443106	449252
Iter 36: InceptionV4/InceptionV4/Mixed_5d/Branch_1/Conv2d_0a_1x1/Conv2D	Convolution	CPU	2926	447278	450204
Iter 37: InceptionV4/InceptionV4/Mixed_5d/Branch_1/Conv2d_0b_3x3/Conv2D	Convolution	CPU	3987	450304	454291
Iter 38: InceptionV4/InceptionV4/Mixed_5d/Branch_3/Conv2d_0b_1x1/Conv2D	Convolution	OpenCL	7072	449451	456523
Iter 39: InceptionV4/InceptionV4/Mixed_5d/Branch_2/Conv2d_0a_1x1/Conv2D	Convolution	CPU	2873	454430	457303
Iter 40: InceptionV4/InceptionV4/Mixed_5d/Branch_2/Conv2d_0b_3x3/Conv2D	Convolution	CPU	3765	457400	461165
Iter 41: InceptionV4/InceptionV4/Mixed_5d/Branch_2/Conv2d_0c_3x3/Conv2D	Convolution	CPU	5565	461371	466936
Iter 42: InceptionV4/InceptionV4/Mixed_5d/concat	Concat	CPU	1379	467149	468528
Iter 43: InceptionV4/InceptionV4/Mixed_5e/Branch_0/Conv2d_0a_1x1/Conv2D	Convolution	CPU	4038	468593	472631
Iter 44: InceptionV4/InceptionV4/Mixed_5e/Branch_3/AvgPool_0a_3x3/AvgPool	Pooling	OpenCL	6110	468742	474852
Iter 45: InceptionV4/InceptionV4/Mixed_5e/Branch_1/Conv2d_0a_1x1/Conv2D	Convolution	CPU	2919	472798	475717
Iter 46: InceptionV4/InceptionV4/Mixed_5e/Branch_1/Conv2d_0b_3x3/Conv2D	Convolution	CPU	4066	475802	479868
Iter 47: InceptionV4/InceptionV4/Mixed_5e/Branch_3/Conv2d_0b_1x1/Conv2D	Convolution	OpenCL	6360	474963	481323
Iter 48: InceptionV4/InceptionV4/Mixed_5e/Branch_2/Conv2d_0a_1x1/Conv2D	Convolution	CPU	2823	480005	482828
Iter 49: InceptionV4/InceptionV4/Mixed_5e/Branch_2/Conv2d_0b_3x3/Conv2D	Convolution	CPU	3821	482917	486738
Iter 50: InceptionV4/InceptionV4/Mixed_5e/Branch_2/Conv2d_0c_3x3/Conv2D	Convolution	CPU	5535	486885	492420
Iter 51: InceptionV4/InceptionV4/Mixed_5e/concat	Concat	CPU	1426	492593	494019
Iter 52: InceptionV4/InceptionV4/Mixed_6a/Branch_1/Conv2d_0a_1x1/Conv2D	Convolution	CPU	7766	494079	501845
Iter 53: InceptionV4/InceptionV4/Mixed_6a/Branch_1/Conv2d_0b_3x3/Conv2D	Convolution	CPU	26311	501995	528306
Iter 54: InceptionV4/InceptionV4/Mixed_6a/Branch_1/Conv2d_1a_3x3/Conv2D	Convolution	CPU	17151	528454	545605
Iter 55: InceptionV4/InceptionV4/Mixed_6a/Branch_2/MaxPool_1a_3x3/MaxPool	Pooling	CPU	902	545761	546663
Iter 56: InceptionV4/InceptionV4/Mixed_6a/Branch_0/Conv2d_1a_3x3/Conv2D	Convolution	OpenCL	73510	494256	567766
Iter 57: InceptionV4/InceptionV4/Mixed_6a/concat	Concat	CPU	21617	546784	568401
Iter 58: InceptionV4/InceptionV4/Mixed_6b/Branch_1/Conv2d_0a_1x1/Conv2D	Convolution	OpenCL	9430	568536	577966
Iter 59: InceptionV4/InceptionV4/Mixed_6b/Branch_0/Conv2d_0a_1x1/Conv2D	Convolution	CPU	13352	568452	581804
Iter 60: InceptionV4/InceptionV4/Mixed_6b/Branch_2/Conv2d_0a_1x1/Conv2D	Convolution	CPU	6847	581907	588754
Iter 61: InceptionV4/InceptionV4/Mixed_6b/Branch_1/Conv2d_0b_1x7/Conv2D	Convolution	OpenCL	16073	578091	594164
Iter 62: InceptionV4/InceptionV4/Mixed_6b/Branch_2/Conv2d_0b_7x1/Conv2D	Convolution	CPU	8177	588896	597073
Iter 63: InceptionV4/InceptionV4/Mixed_6b/Branch_2/Conv2d_0c_1x7/Conv2D	Convolution	CPU	8867	597186	606053
Iter 64: InceptionV4/InceptionV4/Mixed_6b/Branch_1/Conv2d_0c_7x1/Conv2D	Convolution	OpenCL	19721	594284	614005
Iter 65: InceptionV4/InceptionV4/Mixed_6b/Branch_2/Conv2d_0d_7x1/Conv2D	Convolution	CPU	12122	606193	618315
Iter 66: InceptionV4/InceptionV4/Mixed_6b/Branch_3/AvgPool_0a_3x3/AvgPool	Pooling	OpenCL	7902	614217	622119
Iter 67: InceptionV4/InceptionV4/Mixed_6b/Branch_3/Conv2d_0b_1x1/Conv2D	Convolution	OpenCL	5739	622241	627980
Iter 68: InceptionV4/InceptionV4/Mixed_6b/Branch_2/Conv2d_0e_1x7/Conv2D	Convolution	CPU	13921	618496	632417
Iter 69: InceptionV4/InceptionV4/Mixed_6b/concat	Concat	CPU	1059	632572	633631
Iter 70: InceptionV4/InceptionV4/Mixed_6c/Branch_1/Conv2d_0a_1x1/Conv2D	Convolution	OpenCL	9434	633893	643327
Iter 71: InceptionV4/InceptionV4/Mixed_6c/Branch_0/Conv2d_0a_1x1/Conv2D	Convolution	CPU	13439	633690	647129
Iter 72: InceptionV4/InceptionV4/Mixed_6c/Branch_2/Conv2d_0a_1x1/Conv2D	Convolution	CPU	6820	647236	654056
Iter 73: InceptionV4/InceptionV4/Mixed_6c/Branch_1/Conv2d_0b_1x7/Conv2D	Convolution	OpenCL	16036	643441	659477
Iter 74: InceptionV4/InceptionV4/Mixed_6c/Branch_2/Conv2d_0b_7x1/Conv2D	Convolution	CPU	8178	654190	662368
Iter 75: InceptionV4/InceptionV4/Mixed_6c/Branch_2/Conv2d_0c_1x7/Conv2D	Convolution	CPU	9004	662477	671481
Iter 76: InceptionV4/InceptionV4/Mixed_6c/Branch_1/Conv2d_0c_7x1/Conv2D	Convolution	OpenCL	19708	659598	679306
Iter 77: InceptionV4/InceptionV4/Mixed_6c/Branch_2/Conv2d_0d_7x1/Conv2D	Convolution	CPU	12471	671628	684099
Iter 78: InceptionV4/InceptionV4/Mixed_6c/Branch_3/AvgPool_0a_3x3/AvgPool	Pooling	OpenCL	7694	679417	687111
Iter 79: InceptionV4/InceptionV4/Mixed_6c/Branch_3/Conv2d_0b_1x1/Conv2D	Convolution	OpenCL	5763	687216	692979
Iter 80: InceptionV4/InceptionV4/Mixed_6c/Branch_2/Conv2d_0e_1x7/Conv2D	Convolution	CPU	13180	684295	697475
Iter 81: InceptionV4/InceptionV4/Mixed_6c/concat	Concat	CPU	955	697624	698579
Iter 82: InceptionV4/InceptionV4/Mixed_6d/Branch_1/Conv2d_0a_1x1/Conv2D	Convolution	OpenCL	9462	698742	708204
Iter 83: InceptionV4/InceptionV4/Mixed_6d/Branch_0/Conv2d_0a_1x1/Conv2D	Convolution	CPU	13129	698642	711771
Iter 84: InceptionV4/InceptionV4/Mixed_6d/Branch_2/Conv2d_0a_1x1/Conv2D	Convolution	CPU	6759	711867	718626
Iter 85: InceptionV4/InceptionV4/Mixed_6d/Branch_1/Conv2d_0b_1x7/Conv2D	Convolution	OpenCL	16057	708342	724399
Iter 86: InceptionV4/InceptionV4/Mixed_6d/Branch_2/Conv2d_0b_7x1/Conv2D	Convolution	CPU	8203	718756	726959
Iter 87: InceptionV4/InceptionV4/Mixed_6d/Branch_2/Conv2d_0c_1x7/Conv2D	Convolution	CPU	8721	727061	735782
Iter 88: InceptionV4/InceptionV4/Mixed_6d/Branch_1/Conv2d_0c_7x1/Conv2D	Convolution	OpenCL	19902	724540	744442
Iter 89: InceptionV4/InceptionV4/Mixed_6d/Branch_2/Conv2d_0d_7x1/Conv2D	Convolution	CPU	11779	735930	747709
Iter 90: InceptionV4/InceptionV4/Mixed_6d/Branch_3/AvgPool_0a_3x3/AvgPool	Pooling	OpenCL	7517	744589	752106
Iter 91: InceptionV4/InceptionV4/Mixed_6d/Branch_3/Conv2d_0b_1x1/Conv2D	Convolution	OpenCL	5896	752198	758094
Iter 92: InceptionV4/InceptionV4/Mixed_6d/Branch_2/Conv2d_0e_1x7/Conv2D	Convolution	CPU	14119	747916	762035
Iter 93: InceptionV4/Logits/PreLogitsFlatten/flatten/strided_slice/stack	Const	CPU	1	762270	762271
Iter 94: InceptionV4/Logits/PreLogitsFlatten/flatten/strided_slice/stack_1	Const	CPU	1	762339	762340
Iter 95: InceptionV4/Logits/PreLogitsFlatten/flatten/strided_slice/stack_2	Const	CPU	1	762393	762394
Iter 96: InceptionV4/Logits/PreLogitsFlatten/flatten/Reshape/shape/1	Const	CPU	0	762450	762450
Iter 97: InceptionV4/Logits/Logits/weights	Const	CPU	1	762506	762507
Iter 98: InceptionV4/Logits/Logits/biases	Const	CPU	1	762561	762562
Iter 99: InceptionV4/InceptionV4/Mixed_6d/concat	Concat	OpenCL	1852	762234	764086
Iter 100: InceptionV4/InceptionV4/Mixed_6e/Branch_1/Conv2d_0a_1x1/Conv2D	Convolution	OpenCL	7829	764146	771975
Iter 101: InceptionV4/InceptionV4/Mixed_6e/Branch_0/Conv2d_0a_1x1/Conv2D	Convolution	CPU	21846	764246	786092
Iter 102: InceptionV4/InceptionV4/Mixed_6e/Branch_1/Conv2d_0b_1x7/Conv2D	Convolution	OpenCL	15917	772028	787945
Iter 103: InceptionV4/InceptionV4/Mixed_6e/Branch_2/Conv2d_0a_1x1/Conv2D	Convolution	CPU	9617	786251	795868
Iter 104: InceptionV4/InceptionV4/Mixed_6e/Branch_2/Conv2d_0b_7x1/Conv2D	Convolution	CPU	8017	796015	804032
Iter 105: InceptionV4/InceptionV4/Mixed_6e/Branch_1/Conv2d_0c_7x1/Conv2D	Convolution	OpenCL	19918	788012	807930
Iter 106: InceptionV4/InceptionV4/Mixed_6e/Branch_3/AvgPool_0a_3x3/AvgPool	Pooling	OpenCL	6444	808064	814508
Iter 107: InceptionV4/InceptionV4/Mixed_6e/Branch_2/Conv2d_0c_1x7/Conv2D	Convolution	CPU	12337	804180	816517
Iter 108: InceptionV4/InceptionV4/Mixed_6e/Branch_3/Conv2d_0b_1x1/Conv2D	Convolution	OpenCL	5924	814625	820549
Iter 109: InceptionV4/InceptionV4/Mixed_6e/Branch_2/Conv2d_0d_7x1/Conv2D	Convolution	CPU	10753	816605	827358
Iter 110: InceptionV4/InceptionV4/Mixed_6e/Branch_2/Conv2d_0e_1x7/Conv2D	Convolution	CPU	11397	827535	838932
Iter 111: InceptionV4/InceptionV4/Mixed_6e/concat	Concat	CPU	986	839111	840097
Iter 112: InceptionV4/InceptionV4/Mixed_6f/Branch_1/Conv2d_0a_1x1/Conv2D	Convolution	OpenCL	9379	840306	849685
Iter 113: InceptionV4/InceptionV4/Mixed_6f/Branch_0/Conv2d_0a_1x1/Conv2D	Convolution	CPU	13247	840157	853404
Iter 114: InceptionV4/InceptionV4/Mixed_6f/Branch_2/Conv2d_0a_1x1/Conv2D	Convolution	CPU	6799	853501	860300
Iter 115: InceptionV4/InceptionV4/Mixed_6f/Branch_1/Conv2d_0b_1x7/Conv2D	Convolution	OpenCL	15973	849817	865790
Iter 116: InceptionV4/InceptionV4/Mixed_6f/Branch_2/Conv2d_0b_7x1/Conv2D	Convolution	CPU	8168	860446	868614
Iter 117: InceptionV4/InceptionV4/Mixed_6f/Branch_2/Conv2d_0c_1x7/Conv2D	Convolution	CPU	8935	868723	877658
Iter 118: InceptionV4/InceptionV4/Mixed_6f/Branch_1/Conv2d_0c_7x1/Conv2D	Convolution	OpenCL	20677	865911	886588
Iter 119: InceptionV4/InceptionV4/Mixed_6f/Branch_2/Conv2d_0d_7x1/Conv2D	Convolution	CPU	11770	877792	889562
Iter 120: InceptionV4/InceptionV4/Mixed_6f/Branch_3/AvgPool_0a_3x3/AvgPool	Pooling	OpenCL	7339	886708	894047
Iter 121: InceptionV4/InceptionV4/Mixed_6f/Branch_3/Conv2d_0b_1x1/Conv2D	Convolution	OpenCL	5840	894138	899978
Iter 122: InceptionV4/InceptionV4/Mixed_6f/Branch_2/Conv2d_0e_1x7/Conv2D	Convolution	CPU	14241	889763	904004
Iter 123: InceptionV4/InceptionV4/Mixed_6f/concat	Concat	OpenCL	2075	904178	906253
Iter 124: InceptionV4/InceptionV4/Mixed_6g/Branch_1/Conv2d_0a_1x1/Conv2D	Convolution	OpenCL	7804	906351	914155
Iter 125: InceptionV4/InceptionV4/Mixed_6g/Branch_0/Conv2d_0a_1x1/Conv2D	Convolution	CPU	21763	906414	928177
Iter 126: InceptionV4/InceptionV4/Mixed_6g/Branch_1/Conv2d_0b_1x7/Conv2D	Convolution	OpenCL	15748	914205	929953
Iter 127: InceptionV4/InceptionV4/Mixed_6g/Branch_2/Conv2d_0a_1x1/Conv2D	Convolution	CPU	10403	928331	938734
Iter 128: InceptionV4/InceptionV4/Mixed_6g/Branch_2/Conv2d_0b_7x1/Conv2D	Convolution	CPU	8009	938870	946879
Iter 129: InceptionV4/InceptionV4/Mixed_6g/Branch_1/Conv2d_0c_7x1/Conv2D	Convolution	OpenCL	21011	930023	951034
Iter 130: InceptionV4/InceptionV4/Mixed_6g/Branch_3/AvgPool_0a_3x3/AvgPool	Pooling	OpenCL	6454	951164	957618
Iter 131: InceptionV4/InceptionV4/Mixed_6g/Branch_2/Conv2d_0c_1x7/Conv2D	Convolution	CPU	12041	947086	959127
Iter 132: InceptionV4/InceptionV4/Mixed_6g/Branch_3/Conv2d_0b_1x1/Conv2D	Convolution	OpenCL	5858	957722	963580
Iter 133: InceptionV4/InceptionV4/Mixed_6g/Branch_2/Conv2d_0d_7x1/Conv2D	Convolution	CPU	10763	959208	969971
Iter 134: InceptionV4/InceptionV4/Mixed_6g/Branch_2/Conv2d_0e_1x7/Conv2D	Convolution	CPU	11456	970155	981611
Iter 135: InceptionV4/InceptionV4/Mixed_6g/concat	Concat	OpenCL	2130	981856	983986
Iter 136: InceptionV4/InceptionV4/Mixed_6h/Branch_1/Conv2d_0a_1x1/Conv2D	Convolution	OpenCL	8540	984050	992590
Iter 137: InceptionV4/InceptionV4/Mixed_6h/Branch_0/Conv2d_0a_1x1/Conv2D	Convolution	CPU	22486	984139	1006625
Iter 138: InceptionV4/InceptionV4/Mixed_6h/Branch_1/Conv2d_0b_1x7/Conv2D	Convolution	OpenCL	15828	992641	1008469
Iter 139: InceptionV4/InceptionV4/Mixed_6h/Branch_2/Conv2d_0a_1x1/Conv2D	Convolution	CPU	9748	1006781	1016529
Iter 140: InceptionV4/InceptionV4/Mixed_6h/Branch_2/Conv2d_0b_7x1/Conv2D	Convolution	CPU	7939	1016661	1024600
Iter 141: InceptionV4/InceptionV4/Mixed_6h/Branch_1/Conv2d_0c_7x1/Conv2D	Convolution	OpenCL	20091	1008536	1028627
Iter 142: InceptionV4/InceptionV4/Mixed_6h/Branch_3/AvgPool_0a_3x3/AvgPool	Pooling	OpenCL	6421	1028747	1035168
Iter 143: InceptionV4/InceptionV4/Mixed_6h/Branch_2/Conv2d_0c_1x7/Conv2D	Convolution	CPU	12224	1024741	1036965
Iter 144: InceptionV4/InceptionV4/Mixed_6h/Branch_3/Conv2d_0b_1x1/Conv2D	Convolution	OpenCL	5856	1035286	1041142
Iter 145: InceptionV4/InceptionV4/Mixed_6h/Branch_2/Conv2d_0d_7x1/Conv2D	Convolution	CPU	10628	1037045	1047673
Iter 146: InceptionV4/InceptionV4/Mixed_6h/Branch_2/Conv2d_0e_1x7/Conv2D	Convolution	CPU	11295	1047893	1059188
Iter 147: InceptionV4/InceptionV4/Mixed_6h/concat	Concat	OpenCL	2161	1059434	1061595
Iter 148: InceptionV4/InceptionV4/Mixed_7a/Branch_0/Conv2d_0a_1x1/Conv2D	Convolution	OpenCL	7793	1061652	1069445
Iter 149: InceptionV4/InceptionV4/Mixed_7a/Branch_0/Conv2d_1a_3x3/Conv2D	Convolution	OpenCL	4522	1069496	1074018
Iter 150: InceptionV4/InceptionV4/Mixed_7a/Branch_2/MaxPool_1a_3x3/MaxPool	Pooling	OpenCL	2600	1074120	1076720
Iter 151: InceptionV4/InceptionV4/Mixed_7a/Branch_1/Conv2d_0a_1x1/Conv2D	Convolution	CPU	19078	1061743	1080821
Iter 152: InceptionV4/InceptionV4/Mixed_7a/Branch_1/Conv2d_0b_1x7/Conv2D	Convolution	CPU	13300	1080958	1094258
Iter 153: InceptionV4/InceptionV4/Mixed_7a/Branch_1/Conv2d_0c_7x1/Conv2D	Convolution	CPU	17067	1094502	1111569
Iter 154: InceptionV4/InceptionV4/Mixed_7a/Branch_1/Conv2d_1a_3x3/Conv2D	Convolution	CPU	8406	1111744	1120150
Iter 155: InceptionV4/InceptionV4/Mixed_7a/concat	Concat	CPU	465	1120383	1120848
Iter 156: InceptionV4/InceptionV4/Mixed_7b/Branch_0/Conv2d_0a_1x1/Conv2D	Convolution	OpenCL	4103	1121012	1125115
Iter 157: InceptionV4/InceptionV4/Mixed_7b/Branch_2/Conv2d_0a_1x1/Conv2D	Convolution	CPU	5011	1120899	1125910
Iter 158: InceptionV4/InceptionV4/Mixed_7b/Branch_2/Conv2d_0b_3x1/Conv2D	Convolution	CPU	4859	1126006	1130865
Iter 159: InceptionV4/InceptionV4/Mixed_7b/Branch_1/Conv2d_0a_1x1/Conv2D	Convolution	OpenCL	5871	1125240	1131111
Iter 160: InceptionV4/InceptionV4/Mixed_7b/Branch_1/Conv2d_0b_1x3/Conv2D	Convolution	OpenCL	3960	1131183	1135143
Iter 161: InceptionV4/InceptionV4/Mixed_7b/Branch_2/Conv2d_0c_1x3/Conv2D	Convolution	CPU	6964	1130994	1137958
Iter 162: InceptionV4/InceptionV4/Mixed_7b/Branch_1/Conv2d_0c_3x1/Conv2D	Convolution	OpenCL	3974	1135258	1139232
Iter 163: InceptionV4/InceptionV4/Mixed_7b/Branch_1/concat	Concat	OpenCL	1381	1139333	1140714
Iter 164: InceptionV4/InceptionV4/Mixed_7b/Branch_2/Conv2d_0d_1x3/Conv2D	Convolution	CPU	4198	1138050	1142248
Iter 165: InceptionV4/InceptionV4/Mixed_7b/Branch_3/AvgPool_0a_3x3/AvgPool	Pooling	OpenCL	3151	1140783	1143934
Iter 166: InceptionV4/InceptionV4/Mixed_7b/Branch_2/Conv2d_0e_3x1/Conv2D	Convolution	CPU	4259	1142383	1146642
Iter 167: InceptionV4/InceptionV4/Mixed_7b/Branch_2/concat	Concat	CPU	84	1146737	1146821
Iter 168: InceptionV4/InceptionV4/Mixed_7b/Branch_3/Conv2d_0b_1x1/Conv2D	Convolution	OpenCL	3427	1144029	1147456
Iter 169: InceptionV4/InceptionV4/Mixed_7b/concat	Concat	CPU	1104	1146867	1147971
Iter 170: InceptionV4/InceptionV4/Mixed_7c/Branch_0/Conv2d_0a_1x1/Conv2D	Convolution	CPU	3605	1148017	1151622
Iter 171: InceptionV4/InceptionV4/Mixed_7c/Branch_1/Conv2d_0a_1x1/Conv2D	Convolution	OpenCL	5596	1148141	1153737
Iter 172: InceptionV4/InceptionV4/Mixed_7c/Branch_2/Conv2d_0a_1x1/Conv2D	Convolution	CPU	5457	1151750	1157207
Iter 173: InceptionV4/InceptionV4/Mixed_7c/Branch_1/Conv2d_0b_1x3/Conv2D	Convolution	OpenCL	4171	1153899	1158070
Iter 174: InceptionV4/InceptionV4/Mixed_7c/Branch_1/Conv2d_0c_3x1/Conv2D	Convolution	OpenCL	3700	1158252	1161952
Iter 175: InceptionV4/InceptionV4/Mixed_7c/Branch_2/Conv2d_0b_3x1/Conv2D	Convolution	CPU	5138	1157348	1162486
Iter 176: InceptionV4/InceptionV4/Mixed_7c/Branch_1/concat	Concat	OpenCL	1463	1162131	1163594
Iter 177: InceptionV4/InceptionV4/Mixed_7c/Branch_3/AvgPool_0a_3x3/AvgPool	Pooling	OpenCL	3252	1163733	1166985
Iter 178: InceptionV4/InceptionV4/Mixed_7c/Branch_2/Conv2d_0c_1x3/Conv2D	Convolution	CPU	7175	1162571	1169746
Iter 179: InceptionV4/InceptionV4/Mixed_7c/Branch_3/Conv2d_0b_1x1/Conv2D	Convolution	OpenCL	3520	1167183	1170703
Iter 180: InceptionV4/InceptionV4/Mixed_7c/Branch_2/Conv2d_0d_1x3/Conv2D	Convolution	CPU	3526	1169832	1173358
Iter 181: InceptionV4/InceptionV4/Mixed_7c/Branch_2/Conv2d_0e_3x1/Conv2D	Convolution	CPU	3498	1173459	1176957
Iter 182: InceptionV4/InceptionV4/Mixed_7c/Branch_2/concat	Concat	CPU	81	1177078	1177159
Iter 183: InceptionV4/InceptionV4/Mixed_7c/concat	Concat	CPU	362	1177224	1177586
Iter 184: InceptionV4/InceptionV4/Mixed_7d/Branch_0/Conv2d_0a_1x1/Conv2D	Convolution	CPU	3630	1177632	1181262
Iter 185: InceptionV4/InceptionV4/Mixed_7d/Branch_1/Conv2d_0a_1x1/Conv2D	Convolution	OpenCL	5911	1177741	1183652
Iter 186: InceptionV4/InceptionV4/Mixed_7d/Branch_2/Conv2d_0a_1x1/Conv2D	Convolution	CPU	5561	1181382	1186943
Iter 187: InceptionV4/InceptionV4/Mixed_7d/Branch_1/Conv2d_0b_1x3/Conv2D	Convolution	OpenCL	4859	1183784	1188643
Iter 188: InceptionV4/InceptionV4/Mixed_7d/Branch_2/Conv2d_0b_3x1/Conv2D	Convolution	CPU	5109	1187085	1192194
Iter 189: InceptionV4/InceptionV4/Mixed_7d/Branch_1/Conv2d_0c_3x1/Conv2D	Convolution	OpenCL	3793	1188786	1192579
Iter 190: InceptionV4/InceptionV4/Mixed_7d/Branch_1/concat	Concat	OpenCL	1432	1192677	1194109
Iter 191: InceptionV4/InceptionV4/Mixed_7d/Branch_3/AvgPool_0a_3x3/AvgPool	Pooling	OpenCL	3020	1194196	1197216
Iter 192: InceptionV4/InceptionV4/Mixed_7d/Branch_2/Conv2d_0c_1x3/Conv2D	Convolution	CPU	7289	1192298	1199587
Iter 193: InceptionV4/InceptionV4/Mixed_7d/Branch_3/Conv2d_0b_1x1/Conv2D	Convolution	OpenCL	3542	1197312	1200854
Iter 194: InceptionV4/InceptionV4/Mixed_7d/Branch_2/Conv2d_0d_1x3/Conv2D	Convolution	CPU	3573	1199668	1203241
Iter 195: InceptionV4/InceptionV4/Mixed_7d/Branch_2/Conv2d_0e_3x1/Conv2D	Convolution	CPU	3486	1203335	1206821
Iter 196: InceptionV4/InceptionV4/Mixed_7d/Branch_2/concat	Concat	CPU	79	1206930	1207009
Iter 197: InceptionV4/InceptionV4/Mixed_7d/concat	Concat	CPU	351	1207054	1207405
Iter 198: InceptionV4/Logits/AvgPool_1a/AvgPool	Pooling	CPU	174	1207480	1207654
Iter 199: InceptionV4/Logits/PreLogitsFlatten/flatten/Shape	Shape	CPU	1	1207713	1207714
Iter 200: InceptionV4/Logits/PreLogitsFlatten/flatten/strided_slice	StridedSlice	CPU	1	1207768	1207769
Iter 201: InceptionV4/Logits/PreLogitsFlatten/flatten/Reshape/shape	Pack	CPU	1	1207813	1207814
Iter 202: InceptionV4/Logits/AvgPool_1a/AvgPool___tr4InceptionV4/Logits/PreLogitsFlatten/flatten/Reshape	ConvertTensor	CPU	17	1207865	1207882
Iter 203: InceptionV4/Logits/PreLogitsFlatten/flatten/Reshape	Reshape	CPU	4	1207934	1207938
Iter 204: InceptionV4/Logits/Logits/MatMul	MatMul	CPU	20436	1207987	1228423
Iter 205: InceptionV4/Logits/Logits/BiasAdd	BinaryOp	CPU	46	1228530	1228576
Iter 206: InceptionV4/Logits/Predictions	Softmax	CPU	21	1228627	1228648
Iter 0: InceptionV4/InceptionV4/Conv2d_1a_3x3/Conv2D	Convolution	CPU	5436	4300	9736
Iter 1: InceptionV4/InceptionV4/Conv2d_2a_3x3/Conv2D	Convolution	CPU	11230	9993	21223
Iter 2: InceptionV4/InceptionV4/Conv2d_2b_3x3/Conv2D	Convolution	CPU	21589	21450	43039
Iter 3: InceptionV4/InceptionV4/Mixed_3a/Branch_0/MaxPool_0a_3x3/MaxPool	Pooling	CPU	1771	43250	45021
Iter 4: InceptionV4/InceptionV4/Mixed_3a/Branch_1/Conv2d_0a_3x3/Conv2D	Convolution	CPU	27637	45133	72770
Iter 5: InceptionV4/InceptionV4/Mixed_3a/concat	Concat	CPU	2096	73075	75171
Iter 6: InceptionV4/InceptionV4/Mixed_4a/Branch_1/Conv2d_0a_1x1/Conv2D	Convolution	CPU	4812	75234	80046
Iter 7: InceptionV4/InceptionV4/Mixed_4a/Branch_0/Conv2d_0a_1x1/Conv2D	Convolution	OpenCL	14380	75390	89770
Iter 8: InceptionV4/InceptionV4/Mixed_4a/Branch_1/Conv2d_0b_1x7/Conv2D	Convolution	CPU	14548	80186	94734
Iter 9: InceptionV4/InceptionV4/Mixed_4a/Branch_1/Conv2d_0c_7x1/Conv2D	Convolution	CPU	15944	94950	110894
Iter 10: InceptionV4/InceptionV4/Mixed_4a/Branch_0/Conv2d_1a_3x3/Conv2D	Convolution	OpenCL	29486	89869	119355
Iter 11: InceptionV4/InceptionV4/Mixed_4a/Branch_1/Conv2d_1a_3x3/Conv2D	Convolution	CPU	15647	111188	126835
Iter 12: InceptionV4/InceptionV4/Mixed_4a/concat	Concat	CPU	3246	127114	130360
Iter 13: InceptionV4/InceptionV4/Mixed_5a/Branch_0/Conv2d_1a_3x3/Conv2D	Convolution	CPU	37527	130414	167941
Iter 14: InceptionV4/InceptionV4/Mixed_5a/Branch_1/MaxPool_1a_3x3/MaxPool	Pooling	CPU	1432	168108	169540
Iter 15: InceptionV4/InceptionV4/Mixed_5a/concat	Concat	CPU	1188	169880	171068
Iter 16: InceptionV4/InceptionV4/Mixed_5b/Branch_0/Conv2d_0a_1x1/Conv2D	Convolution	CPU	3887	171126	175013
Iter 17: InceptionV4/InceptionV4/Mixed_5b/Branch_1/Conv2d_0a_1x1/Conv2D	Convolution	OpenCL	6193	171402	177595
Iter 18: InceptionV4/InceptionV4/Mixed_5b/Branch_2/Conv2d_0a_1x1/Conv2D	Convolution	CPU	2736	175150	177886
Iter 19: InceptionV4/InceptionV4/Mixed_5b/Branch_2/Conv2d_0b_3x3/Conv2D	Convolution	CPU	5143	177979	183122
Iter 20: InceptionV4/InceptionV4/Mixed_5b/Branch_1/Conv2d_0b_3x3/Conv2D	Convolution	OpenCL	9353	177871	187224
Iter 21: InceptionV4/InceptionV4/Mixed_5b/Branch_2/Conv2d_0c_3x3/Conv2D	Convolution	CPU	7260	183312	190572
Iter 22: InceptionV4/InceptionV4/Mixed_5b/Branch_3/AvgPool_0a_3x3/AvgPool	Pooling	CPU	1965	190716	192681
Iter 23: InceptionV4/InceptionV4/Mixed_5b/Branch_3/Conv2d_0b_1x1/Conv2D	Convolution	CPU	3881	192792	196673
Iter 24: InceptionV4/InceptionV4/Mixed_5b/concat	Concat	CPU	1480	196803	198283
Iter 25: InceptionV4/InceptionV4/Mixed_5c/Branch_0/Conv2d_0a_1x1/Conv2D	Convolution	CPU	4055	198340	202395
Iter 26: InceptionV4/InceptionV4/Mixed_5c/Branch_3/AvgPool_0a_3x3/AvgPool	Pooling	OpenCL	6269	198492	204761
Iter 27: InceptionV4/InceptionV4/Mixed_5c/Branch_1/Conv2d_0a_1x1/Conv2D	Convolution	CPU	2998	202567	205565
Iter 28: InceptionV4/InceptionV4/Mixed_5c/Branch_1/Conv2d_0b_3x3/Conv2D	Convolution	CPU	4146	205716	209862
Iter 29: InceptionV4/InceptionV4/Mixed_5c/Branch_3/Conv2d_0b_1x1/Conv2D	Convolution	OpenCL	6355	204933	211288
Iter 30: InceptionV4/InceptionV4/Mixed_5c/Branch_2/Conv2d_0a_1x1/Conv2D	Convolution	CPU	2844	209997	212841
Iter 31: InceptionV4/InceptionV4/Mixed_5c/Branch_2/Conv2d_0b_3x3/Conv2D	Convolution	CPU	4052	212950	217002
Iter 32: InceptionV4/InceptionV4/Mixed_5c/Branch_2/Conv2d_0c_3x3/Conv2D	Convolution	CPU	5721	217139	222860
Iter 33: InceptionV4/InceptionV4/Mixed_5c/concat	Concat	CPU	1521	223083	224604
Iter 34: InceptionV4/InceptionV4/Mixed_5d/Branch_0/Conv2d_0a_1x1/Conv2D	Convolution	CPU	4172	224660	228832
Iter 35: InceptionV4/InceptionV4/Mixed_5d/Branch_3/AvgPool_0a_3x3/AvgPool	Pooling	OpenCL	6547	224771	231318
Iter 36: InceptionV4/InceptionV4/Mixed_5d/Branch_1/Conv2d_0a_1x1/Conv2D	Convolution	CPU	2916	228993	231909
Iter 37: InceptionV4/InceptionV4/Mixed_5d/Branch_1/Conv2d_0b_3x3/Conv2D	Convolution	CPU	4162	232000	236162
Iter 38: InceptionV4/InceptionV4/Mixed_5d/Branch_3/Conv2d_0b_1x1/Conv2D	Convolution	OpenCL	7322	231419	238741
Iter 39: InceptionV4/InceptionV4/Mixed_5d/Branch_2/Conv2d_0a_1x1/Conv2D	Convolution	CPU	2862	236286	239148
Iter 40: InceptionV4/InceptionV4/Mixed_5d/Branch_2/Conv2d_0b_3x3/Conv2D	Convolution	CPU	3978	239252	243230
Iter 41: InceptionV4/InceptionV4/Mixed_5d/Branch_2/Conv2d_0c_3x3/Conv2D	Convolution	CPU	5667	243510	249177
Iter 42: InceptionV4/InceptionV4/Mixed_5d/concat	Concat	CPU	1481	249462	250943
Iter 43: InceptionV4/InceptionV4/Mixed_5e/Branch_0/Conv2d_0a_1x1/Conv2D	Convolution	CPU	4034	251025	255059
Iter 44: InceptionV4/InceptionV4/Mixed_5e/Branch_3/AvgPool_0a_3x3/AvgPool	Pooling	OpenCL	6467	251111	257578
Iter 45: InceptionV4/InceptionV4/Mixed_5e/Branch_1/Conv2d_0a_1x1/Conv2D	Convolution	CPU	2983	255220	258203
Iter 46: InceptionV4/InceptionV4/Mixed_5e/Branch_1/Conv2d_0b_3x3/Conv2D	Convolution	CPU	4125	258300	262425
Iter 47: InceptionV4/InceptionV4/Mixed_5e/Branch_3/Conv2d_0b_1x1/Conv2D	Convolution	OpenCL	6516	257679	264195
Iter 48: InceptionV4/InceptionV4/Mixed_5e/Branch_2/Conv2d_0a_1x1/Conv2D	Convolution	CPU	2877	262572	265449
Iter 49: InceptionV4/InceptionV4/Mixed_5e/Branch_2/Conv2d_0b_3x3/Conv2D	Convolution	CPU	3814	265552	269366
Iter 50: InceptionV4/InceptionV4/Mixed_5e/Branch_2/Conv2d_0c_3x3/Conv2D	Convolution	CPU	5598	269537	275135
Iter 51: InceptionV4/InceptionV4/Mixed_5e/concat	Concat	CPU	1498	275337	276835
Iter 52: InceptionV4/InceptionV4/Mixed_6a/Branch_1/Conv2d_0a_1x1/Conv2D	Convolution	CPU	7715	276895	284610
Iter 53: InceptionV4/InceptionV4/Mixed_6a/Branch_1/Conv2d_0b_3x3/Conv2D	Convolution	CPU	26933	284763	311696
Iter 54: InceptionV4/InceptionV4/Mixed_6a/Branch_1/Conv2d_1a_3x3/Conv2D	Convolution	CPU	17337	311850	329187
Iter 55: InceptionV4/InceptionV4/Mixed_6a/Branch_2/MaxPool_1a_3x3/MaxPool	Pooling	CPU	771	329320	330091
Iter 56: InceptionV4/InceptionV4/Mixed_6a/Branch_0/Conv2d_1a_3x3/Conv2D	Convolution	OpenCL	73486	277053	350539
Iter 57: InceptionV4/InceptionV4/Mixed_6a/concat	Concat	CPU	21443	330206	351649
Iter 58: InceptionV4/InceptionV4/Mixed_6b/Branch_1/Conv2d_0a_1x1/Conv2D	Convolution	OpenCL	9698	351811	361509
Iter 59: InceptionV4/InceptionV4/Mixed_6b/Branch_0/Conv2d_0a_1x1/Conv2D	Convolution	CPU	13303	351710	365013
Iter 60: InceptionV4/InceptionV4/Mixed_6b/Branch_2/Conv2d_0a_1x1/Conv2D	Convolution	CPU	6787	365105	371892
Iter 61: InceptionV4/InceptionV4/Mixed_6b/Branch_1/Conv2d_0b_1x7/Conv2D	Convolution	OpenCL	15971	361740	377711
Iter 62: InceptionV4/InceptionV4/Mixed_6b/Branch_2/Conv2d_0b_7x1/Conv2D	Convolution	CPU	8188	372032	380220
Iter 63: InceptionV4/InceptionV4/Mixed_6b/Branch_2/Conv2d_0c_1x7/Conv2D	Convolution	CPU	8936	380323	389259
Iter 64: InceptionV4/InceptionV4/Mixed_6b/Branch_1/Conv2d_0c_7x1/Conv2D	Convolution	OpenCL	19741	377931	397672
Iter 65: InceptionV4/InceptionV4/Mixed_6b/Branch_2/Conv2d_0d_7x1/Conv2D	Convolution	CPU	11724	389402	401126
Iter 66: InceptionV4/InceptionV4/Mixed_6b/Branch_3/AvgPool_0a_3x3/AvgPool	Pooling	OpenCL	7597	397970	405567
Iter 67: InceptionV4/InceptionV4/Mixed_6b/Branch_3/Conv2d_0b_1x1/Conv2D	Convolution	OpenCL	5903	405830	411733
Iter 68: InceptionV4/InceptionV4/Mixed_6b/Branch_2/Conv2d_0e_1x7/Conv2D	Convolution	CPU	14105	401333	415438
Iter 69: InceptionV4/InceptionV4/Mixed_6b/concat	Concat	CPU	1093	415555	416648
Iter 70: InceptionV4/InceptionV4/Mixed_6c/Branch_1/Conv2d_0a_1x1/Conv2D	Convolution	OpenCL	9662	416791	426453
Iter 71: InceptionV4/InceptionV4/Mixed_6c/Branch_0/Conv2d_0a_1x1/Conv2D	Convolution	CPU	13266	416706	429972
Iter 72: InceptionV4/InceptionV4/Mixed_6c/Branch_2/Conv2d_0a_1x1/Conv2D	Convolution	CPU	6881	430074	436955
Iter 73: InceptionV4/InceptionV4/Mixed_6c/Branch_1/Conv2d_0b_1x7/Conv2D	Convolution	OpenCL	15996	426582	442578
Iter 74: InceptionV4/InceptionV4/Mixed_6c/Branch_2/Conv2d_0b_7x1/Conv2D	Convolution	CPU	8107	437083	445190
Iter 75: InceptionV4/InceptionV4/Mixed_6c/Branch_2/Conv2d_0c_1x7/Conv2D	Convolution	CPU	8885	445296	454181
Iter 76: InceptionV4/InceptionV4/Mixed_6c/Branch_1/Conv2d_0c_7x1/Conv2D	Convolution	OpenCL	19640	442698	462338
Iter 77: InceptionV4/InceptionV4/Mixed_6c/Branch_2/Conv2d_0d_7x1/Conv2D	Convolution	CPU	11918	454321	466239
Iter 78: InceptionV4/InceptionV4/Mixed_6c/Branch_3/AvgPool_0a_3x3/AvgPool	Pooling	OpenCL	7607	462483	470090
Iter 79: InceptionV4/InceptionV4/Mixed_6c/Branch_3/Conv2d_0b_1x1/Conv2D	Convolution	OpenCL	5705	470205	475910
Iter 80: InceptionV4/InceptionV4/Mixed_6c/Branch_2/Conv2d_0e_1x7/Conv2D	Convolution	CPU	13753	466431	480184
Iter 81: InceptionV4/InceptionV4/Mixed_6c/concat	Concat	CPU	996	480515	481511
Iter 82: InceptionV4/InceptionV4/Mixed_6d/Branch_1/Conv2d_0a_1x1/Conv2D	Convolution	OpenCL	9332	481732	491064
Iter 83: InceptionV4/InceptionV4/Mixed_6d/Branch_0/Conv2d_0a_1x1/Conv2D	Convolution	CPU	13002	481570	494572
Iter 84: InceptionV4/InceptionV4/Mixed_6d/Branch_2/Conv2d_0a_1x1/Conv2D	Convolution	CPU	6711	494668	501379
Iter 85: InceptionV4/InceptionV4/Mixed_6d/Branch_1/Conv2d_0b_1x7/Conv2D	Convolution	OpenCL	15983	491228	507211
Iter 86: InceptionV4/InceptionV4/Mixed_6d/Branch_2/Conv2d_0b_7x1/Conv2D	Convolution	CPU	8174	501517	509691
Iter 87: InceptionV4/InceptionV4/Mixed_6d/Branch_2/Conv2d_0c_1x7/Conv2D	Convolution	CPU	8786	509797	518583
Iter 88: InceptionV4/InceptionV4/Mixed_6d/Branch_1/Conv2d_0c_7x1/Conv2D	Convolution	OpenCL	19814	507364	527178
Iter 89: InceptionV4/InceptionV4/Mixed_6d/Branch_2/Conv2d_0d_7x1/Conv2D	Convolution	CPU	11772	518724	530496
Iter 90: InceptionV4/InceptionV4/Mixed_6d/Branch_3/AvgPool_0a_3x3/AvgPool	Pooling	OpenCL	7484	527314	534798
Iter 91: InceptionV4/InceptionV4/Mixed_6d/Branch_3/Conv2d_0b_1x1/Conv2D	Convolution	OpenCL	5749	534898	540647
Iter 92: InceptionV4/InceptionV4/Mixed_6d/Branch_2/Conv2d_0e_1x7/Conv2D	Convolution	CPU	14063	530686	544749
Iter 93: InceptionV4/Logits/PreLogitsFlatten/flatten/strided_slice/stack	Const	CPU	0	544992	544992
Iter 94: InceptionV4/Logits/PreLogitsFlatten/flatten/strided_slice/stack_1	Const	CPU	0	545048	545048
Iter 95: InceptionV4/Logits/PreLogitsFlatten/flatten/strided_slice/stack_2	Const	CPU	1	545100	545101
Iter 96: InceptionV4/Logits/PreLogitsFlatten/flatten/Reshape/shape/1	Const	CPU	0	545158	545158
Iter 97: InceptionV4/Logits/Logits/weights	Const	CPU	1	545209	545210
Iter 98: InceptionV4/Logits/Logits/biases	Const	CPU	1	545265	545266
Iter 99: InceptionV4/InceptionV4/Mixed_6d/concat	Concat	OpenCL	2182	544953	547135
Iter 100: InceptionV4/InceptionV4/Mixed_6e/Branch_1/Conv2d_0a_1x1/Conv2D	Convolution	OpenCL	8523	547197	555720
Iter 101: InceptionV4/InceptionV4/Mixed_6e/Branch_0/Conv2d_0a_1x1/Conv2D	Convolution	CPU	21349	547299	568648
Iter 102: InceptionV4/InceptionV4/Mixed_6e/Branch_1/Conv2d_0b_1x7/Conv2D	Convolution	OpenCL	15686	555786	571472
Iter 103: InceptionV4/InceptionV4/Mixed_6e/Branch_2/Conv2d_0a_1x1/Conv2D	Convolution	CPU	10208	568788	578996
Iter 104: InceptionV4/InceptionV4/Mixed_6e/Branch_2/Conv2d_0b_7x1/Conv2D	Convolution	CPU	7990	579128	587118
Iter 105: InceptionV4/InceptionV4/Mixed_6e/Branch_1/Conv2d_0c_7x1/Conv2D	Convolution	OpenCL	20891	571544	592435
Iter 106: InceptionV4/InceptionV4/Mixed_6e/Branch_2/Conv2d_0c_1x7/Conv2D	Convolution	CPU	11446	587248	598694
Iter 107: InceptionV4/InceptionV4/Mixed_6e/Branch_3/AvgPool_0a_3x3/AvgPool	Pooling	OpenCL	6415	592562	598977
Iter 108: InceptionV4/InceptionV4/Mixed_6e/Branch_3/Conv2d_0b_1x1/Conv2D	Convolution	OpenCL	5763	599056	604819
Iter 109: InceptionV4/InceptionV4/Mixed_6e/Branch_2/Conv2d_0d_7x1/Conv2D	Convolution	CPU	11064	598811	609875
Iter 110: InceptionV4/InceptionV4/Mixed_6e/Branch_2/Conv2d_0e_1x7/Conv2D	Convolution	CPU	11485	610032	621517
Iter 111: InceptionV4/InceptionV4/Mixed_6e/concat	Concat	CPU	969	621675	622644
Iter 112: InceptionV4/InceptionV4/Mixed_6f/Branch_1/Conv2d_0a_1x1/Conv2D	Convolution	OpenCL	9551	622746	632297
Iter 113: InceptionV4/InceptionV4/Mixed_6f/Branch_0/Conv2d_0a_1x1/Conv2D	Convolution	CPU	13639	622793	636432
Iter 114: InceptionV4/InceptionV4/Mixed_6f/Branch_2/Conv2d_0a_1x1/Conv2D	Convolution	CPU	6855	636543	643398
Iter 115: InceptionV4/InceptionV4/Mixed_6f/Branch_1/Conv2d_0b_1x7/Conv2D	Convolution	OpenCL	16170	632404	648574
Iter 116: InceptionV4/InceptionV4/Mixed_6f/Branch_2/Conv2d_0b_7x1/Conv2D	Convolution	CPU	8274	643536	651810
Iter 117: InceptionV4/InceptionV4/Mixed_6f/Branch_2/Conv2d_0c_1x7/Conv2D	Convolution	CPU	9270	651934	661204
Iter 118: InceptionV4/InceptionV4/Mixed_6f/Branch_1/Conv2d_0c_7x1/Conv2D	Convolution	OpenCL	20453	648681	669134
Iter 119: InceptionV4/InceptionV4/Mixed_6f/Branch_2/Conv2d_0d_7x1/Conv2D	Convolution	CPU	12432	661337	673769
Iter 120: InceptionV4/InceptionV4/Mixed_6f/Branch_3/AvgPool_0a_3x3/AvgPool	Pooling	OpenCL	7615	669252	676867
Iter 121: InceptionV4/InceptionV4/Mixed_6f/Branch_3/Conv2d_0b_1x1/Conv2D	Convolution	OpenCL	5872	676972	682844
Iter 122: InceptionV4/InceptionV4/Mixed_6f/Branch_2/Conv2d_0e_1x7/Conv2D	Convolution	CPU	13396	673979	687375
Iter 123: InceptionV4/InceptionV4/Mixed_6f/concat	Concat	OpenCL	2169	687591	689760
Iter 124: InceptionV4/InceptionV4/Mixed_6g/Branch_1/Conv2d_0a_1x1/Conv2D	Convolution	OpenCL	8451	689823	698274
Iter 125: InceptionV4/InceptionV4/Mixed_6g/Branch_0/Conv2d_0a_1x1/Conv2D	Convolution	CPU	21705	689910	711615
Iter 126: InceptionV4/InceptionV4/Mixed_6g/Branch_1/Conv2d_0b_1x7/Conv2D	Convolution	OpenCL	16022	698395	714417
Iter 127: InceptionV4/InceptionV4/Mixed_6g/Branch_2/Conv2d_0a_1x1/Conv2D	Convolution	CPU	11376	711759	723135
Iter 128: InceptionV4/InceptionV4/Mixed_6g/Branch_2/Conv2d_0b_7x1/Conv2D	Convolution	CPU	8316	723286	731602
Iter 129: InceptionV4/InceptionV4/Mixed_6g/Branch_1/Conv2d_0c_7x1/Conv2D	Convolution	OpenCL	20695	714483	735178
Iter 130: InceptionV4/InceptionV4/Mixed_6g/Branch_3/AvgPool_0a_3x3/AvgPool	Pooling	OpenCL	6497	735298	741795
Iter 131: InceptionV4/InceptionV4/Mixed_6g/Branch_2/Conv2d_0c_1x7/Conv2D	Convolution	CPU	11257	731813	743070
Iter 132: InceptionV4/InceptionV4/Mixed_6g/Branch_3/Conv2d_0b_1x1/Conv2D	Convolution	OpenCL	5822	741914	747736
Iter 133: InceptionV4/InceptionV4/Mixed_6g/Branch_2/Conv2d_0d_7x1/Conv2D	Convolution	CPU	10834	743184	754018
Iter 134: InceptionV4/InceptionV4/Mixed_6g/Branch_2/Conv2d_0e_1x7/Conv2D	Convolution	CPU	13597	754211	767808
Iter 135: InceptionV4/InceptionV4/Mixed_6g/concat	Concat	OpenCL	2097	767997	770094
Iter 136: InceptionV4/InceptionV4/Mixed_6h/Branch_1/Conv2d_0a_1x1/Conv2D	Convolution	OpenCL	8497	770160	778657
Iter 137: InceptionV4/InceptionV4/Mixed_6h/Branch_0/Conv2d_0a_1x1/Conv2D	Convolution	CPU	22477	770245	792722
Iter 138: InceptionV4/InceptionV4/Mixed_6h/Branch_1/Conv2d_0b_1x7/Conv2D	Convolution	OpenCL	15806	778709	794515
Iter 139: InceptionV4/InceptionV4/Mixed_6h/Branch_2/Conv2d_0a_1x1/Conv2D	Convolution	CPU	9677	792875	802552
Iter 140: InceptionV4/InceptionV4/Mixed_6h/Branch_2/Conv2d_0b_7x1/Conv2D	Convolution	CPU	8063	802735	810798
Iter 141: InceptionV4/InceptionV4/Mixed_6h/Branch_1/Conv2d_0c_7x1/Conv2D	Convolution	OpenCL	19975	794579	814554
Iter 142: InceptionV4/InceptionV4/Mixed_6h/Branch_3/AvgPool_0a_3x3/AvgPool	Pooling	OpenCL	6382	814668	821050
Iter 143: InceptionV4/InceptionV4/Mixed_6h/Branch_2/Conv2d_0c_1x7/Conv2D	Convolution	CPU	12261	810938	823199
Iter 144: InceptionV4/InceptionV4/Mixed_6h/Branch_3/Conv2d_0b_1x1/Conv2D	Convolution	OpenCL	5919	821182	827101
Iter 145: InceptionV4/InceptionV4/Mixed_6h/Branch_2/Conv2d_0d_7x1/Conv2D	Convolution	CPU	10648	823283	833931
Iter 146: InceptionV4/InceptionV4/Mixed_6h/Branch_2/Conv2d_0e_1x7/Conv2D	Convolution	CPU	11364	834112	845476
Iter 147: InceptionV4/InceptionV4/Mixed_6h/concat	Concat	OpenCL	2122	845795	847917
Iter 148: InceptionV4/InceptionV4/Mixed_7a/Branch_0/Conv2d_0a_1x1/Conv2D	Convolution	OpenCL	8387	847981	856368
Iter 149: InceptionV4/InceptionV4/Mixed_7a/Branch_0/Conv2d_1a_3x3/Conv2D	Convolution	OpenCL	4426	856466	860892
Iter 150: InceptionV4/InceptionV4/Mixed_7a/Branch_2/MaxPool_1a_3x3/MaxPool	Pooling	OpenCL	2398	861014	863412
Iter 151: InceptionV4/InceptionV4/Mixed_7a/Branch_1/Conv2d_0a_1x1/Conv2D	Convolution	CPU	18502	848086	866588
Iter 152: InceptionV4/InceptionV4/Mixed_7a/Branch_1/Conv2d_0b_1x7/Conv2D	Convolution	CPU	13238	866692	879930
Iter 153: InceptionV4/InceptionV4/Mixed_7a/Branch_1/Conv2d_0c_7x1/Conv2D	Convolution	CPU	17118	880176	897294
Iter 154: InceptionV4/InceptionV4/Mixed_7a/Branch_1/Conv2d_1a_3x3/Conv2D	Convolution	CPU	8296	897457	905753
Iter 155: InceptionV4/InceptionV4/Mixed_7a/concat	Concat	CPU	481	906024	906505
Iter 156: InceptionV4/InceptionV4/Mixed_7b/Branch_0/Conv2d_0a_1x1/Conv2D	Convolution	OpenCL	3986	906666	910652
Iter 157: InceptionV4/InceptionV4/Mixed_7b/Branch_2/Conv2d_0a_1x1/Conv2D	Convolution	CPU	5039	906557	911596
Iter 158: InceptionV4/InceptionV4/Mixed_7b/Branch_1/Conv2d_0a_1x1/Conv2D	Convolution	OpenCL	5643	910774	916417
Iter 159: InceptionV4/InceptionV4/Mixed_7b/Branch_2/Conv2d_0b_3x1/Conv2D	Convolution	CPU	4918	911690	916608
Iter 160: InceptionV4/InceptionV4/Mixed_7b/Branch_1/Conv2d_0b_1x3/Conv2D	Convolution	OpenCL	4045	916525	920570
Iter 161: InceptionV4/InceptionV4/Mixed_7b/Branch_2/Conv2d_0c_1x3/Conv2D	Convolution	CPU	6930	916684	923614
Iter 162: InceptionV4/InceptionV4/Mixed_7b/Branch_1/Conv2d_0c_3x1/Conv2D	Convolution	OpenCL	3758	920691	924449
Iter 163: InceptionV4/InceptionV4/Mixed_7b/Branch_1/concat	Concat	OpenCL	1401	924534	925935
Iter 164: InceptionV4/InceptionV4/Mixed_7b/Branch_2/Conv2d_0d_1x3/Conv2D	Convolution	CPU	4242	923701	927943
Iter 165: InceptionV4/InceptionV4/Mixed_7b/Branch_3/AvgPool_0a_3x3/AvgPool	Pooling	OpenCL	2790	926024	928814
Iter 166: InceptionV4/InceptionV4/Mixed_7b/Branch_2/Conv2d_0e_3x1/Conv2D	Convolution	CPU	3861	928083	931944
Iter 167: InceptionV4/InceptionV4/Mixed_7b/Branch_2/concat	Concat	CPU	73	932065	932138
Iter 168: InceptionV4/InceptionV4/Mixed_7b/Branch_3/Conv2d_0b_1x1/Conv2D	Convolution	OpenCL	3474	928903	932377
Iter 169: InceptionV4/InceptionV4/Mixed_7b/concat	Concat	CPU	602	932199	932801
Iter 170: InceptionV4/InceptionV4/Mixed_7c/Branch_0/Conv2d_0a_1x1/Conv2D	Convolution	CPU	3622	932862	936484
Iter 171: InceptionV4/InceptionV4/Mixed_7c/Branch_1/Conv2d_0a_1x1/Conv2D	Convolution	OpenCL	5577	932976	938553
Iter 172: InceptionV4/InceptionV4/Mixed_7c/Branch_2/Conv2d_0a_1x1/Conv2D	Convolution	CPU	5373	936607	941980
Iter 173: InceptionV4/InceptionV4/Mixed_7c/Branch_1/Conv2d_0b_1x3/Conv2D	Convolution	OpenCL	4018	938651	942669
Iter 174: InceptionV4/InceptionV4/Mixed_7c/Branch_1/Conv2d_0c_3x1/Conv2D	Convolution	OpenCL	3735	942837	946572
Iter 175: InceptionV4/InceptionV4/Mixed_7c/Branch_2/Conv2d_0b_3x1/Conv2D	Convolution	CPU	5053	942137	947190
Iter 176: InceptionV4/InceptionV4/Mixed_7c/Branch_1/concat	Concat	OpenCL	1303	946667	947970
Iter 177: InceptionV4/InceptionV4/Mixed_7c/Branch_3/AvgPool_0a_3x3/AvgPool	Pooling	OpenCL	2975	948061	951036
Iter 178: InceptionV4/InceptionV4/Mixed_7c/Branch_2/Conv2d_0c_1x3/Conv2D	Convolution	CPU	7099	947293	954392
Iter 179: InceptionV4/InceptionV4/Mixed_7c/Branch_3/Conv2d_0b_1x1/Conv2D	Convolution	OpenCL	3315	951145	954460
Iter 180: InceptionV4/InceptionV4/Mixed_7c/Branch_2/Conv2d_0d_1x3/Conv2D	Convolution	CPU	3433	954641	958074
Iter 181: InceptionV4/InceptionV4/Mixed_7c/Branch_2/Conv2d_0e_3x1/Conv2D	Convolution	CPU	3408	958221	961629
Iter 182: InceptionV4/InceptionV4/Mixed_7c/Branch_2/concat	Concat	CPU	96	961771	961867
Iter 183: InceptionV4/InceptionV4/Mixed_7c/concat	Concat	CPU	353	961997	962350
Iter 184: InceptionV4/InceptionV4/Mixed_7d/Branch_0/Conv2d_0a_1x1/Conv2D	Convolution	CPU	3535	962423	965958
Iter 185: InceptionV4/InceptionV4/Mixed_7d/Branch_1/Conv2d_0a_1x1/Conv2D	Convolution	OpenCL	5394	962523	967917
Iter 186: InceptionV4/InceptionV4/Mixed_7d/Branch_2/Conv2d_0a_1x1/Conv2D	Convolution	CPU	5217	966083	971300
Iter 187: InceptionV4/InceptionV4/Mixed_7d/Branch_1/Conv2d_0b_1x3/Conv2D	Convolution	OpenCL	4745	968100	972845
Iter 188: InceptionV4/InceptionV4/Mixed_7d/Branch_2/Conv2d_0b_3x1/Conv2D	Convolution	CPU	5100	971446	976546
Iter 189: InceptionV4/InceptionV4/Mixed_7d/Branch_1/Conv2d_0c_3x1/Conv2D	Convolution	OpenCL	3660	973020	976680
Iter 190: InceptionV4/InceptionV4/Mixed_7d/Branch_1/concat	Concat	OpenCL	1390	976793	978183
Iter 191: InceptionV4/InceptionV4/Mixed_7d/Branch_3/AvgPool_0a_3x3/AvgPool	Pooling	OpenCL	3000	978354	981354
Iter 192: InceptionV4/InceptionV4/Mixed_7d/Branch_2/Conv2d_0c_1x3/Conv2D	Convolution	CPU	7103	976646	983749
Iter 193: InceptionV4/InceptionV4/Mixed_7d/Branch_3/Conv2d_0b_1x1/Conv2D	Convolution	OpenCL	3385	981514	984899
Iter 194: InceptionV4/InceptionV4/Mixed_7d/Branch_2/Conv2d_0d_1x3/Conv2D	Convolution	CPU	3521	983831	987352
Iter 195: InceptionV4/InceptionV4/Mixed_7d/Branch_2/Conv2d_0e_3x1/Conv2D	Convolution	CPU	3377	987452	990829
Iter 196: InceptionV4/InceptionV4/Mixed_7d/Branch_2/concat	Concat	CPU	76	990950	991026
Iter 197: InceptionV4/InceptionV4/Mixed_7d/concat	Concat	CPU	362	991082	991444
Iter 198: InceptionV4/Logits/AvgPool_1a/AvgPool	Pooling	CPU	159	991490	991649
Iter 199: InceptionV4/Logits/PreLogitsFlatten/flatten/Shape	Shape	CPU	1	991715	991716
Iter 200: InceptionV4/Logits/PreLogitsFlatten/flatten/strided_slice	StridedSlice	CPU	1	991753	991754
Iter 201: InceptionV4/Logits/PreLogitsFlatten/flatten/Reshape/shape	Pack	CPU	1	991789	991790
Iter 202: InceptionV4/Logits/AvgPool_1a/AvgPool___tr4InceptionV4/Logits/PreLogitsFlatten/flatten/Reshape	ConvertTensor	CPU	5	991864	991869
Iter 203: InceptionV4/Logits/PreLogitsFlatten/flatten/Reshape	Reshape	CPU	4	991914	991918
Iter 204: InceptionV4/Logits/Logits/MatMul	MatMul	CPU	15416	991968	1007384
Iter 205: InceptionV4/Logits/Logits/BiasAdd	BinaryOp	CPU	33	1007495	1007528
Iter 206: InceptionV4/Logits/Predictions	Softmax	CPU	21	1007568	1007589
Iter 0: InceptionV4/InceptionV4/Conv2d_1a_3x3/Conv2D	Convolution	CPU	4033	431	4464
Iter 1: InceptionV4/InceptionV4/Conv2d_2a_3x3/Conv2D	Convolution	CPU	11143	4679	15822
Iter 2: InceptionV4/InceptionV4/Conv2d_2b_3x3/Conv2D	Convolution	CPU	21343	16119	37462
Iter 3: InceptionV4/InceptionV4/Mixed_3a/Branch_0/MaxPool_0a_3x3/MaxPool	Pooling	CPU	1618	37767	39385
Iter 4: InceptionV4/InceptionV4/Mixed_3a/Branch_1/Conv2d_0a_3x3/Conv2D	Convolution	CPU	27532	39526	67058
Iter 5: InceptionV4/InceptionV4/Mixed_3a/concat	Concat	CPU	1856	67244	69100
Iter 6: InceptionV4/InceptionV4/Mixed_4a/Branch_1/Conv2d_0a_1x1/Conv2D	Convolution	CPU	4661	69176	73837
Iter 7: InceptionV4/InceptionV4/Mixed_4a/Branch_0/Conv2d_0a_1x1/Conv2D	Convolution	OpenCL	13251	69256	82507
Iter 8: InceptionV4/InceptionV4/Mixed_4a/Branch_1/Conv2d_0b_1x7/Conv2D	Convolution	CPU	14578	73966	88544
Iter 9: InceptionV4/InceptionV4/Mixed_4a/Branch_1/Conv2d_0c_7x1/Conv2D	Convolution	CPU	15847	88779	104626
Iter 10: InceptionV4/InceptionV4/Mixed_4a/Branch_0/Conv2d_1a_3x3/Conv2D	Convolution	OpenCL	29076	82600	111676
Iter 11: InceptionV4/InceptionV4/Mixed_4a/Branch_1/Conv2d_1a_3x3/Conv2D	Convolution	CPU	14765	104986	119751
Iter 12: InceptionV4/InceptionV4/Mixed_4a/concat	Concat	CPU	2896	119950	122846
Iter 13: InceptionV4/InceptionV4/Mixed_5a/Branch_0/Conv2d_1a_3x3/Conv2D	Convolution	CPU	37260	122919	160179
Iter 14: InceptionV4/InceptionV4/Mixed_5a/Branch_1/MaxPool_1a_3x3/MaxPool	Pooling	CPU	1379	160357	161736
Iter 15: InceptionV4/InceptionV4/Mixed_5a/concat	Concat	CPU	1086	161863	162949
Iter 16: InceptionV4/InceptionV4/Mixed_5b/Branch_0/Conv2d_0a_1x1/Conv2D	Convolution	CPU	3874	163031	166905
Iter 17: InceptionV4/InceptionV4/Mixed_5b/Branch_1/Conv2d_0a_1x1/Conv2D	Convolution	OpenCL	5698	163114	168812
Iter 18: InceptionV4/InceptionV4/Mixed_5b/Branch_2/Conv2d_0a_1x1/Conv2D	Convolution	CPU	2735	167043	169778
Iter 19: InceptionV4/InceptionV4/Mixed_5b/Branch_2/Conv2d_0b_3x3/Conv2D	Convolution	CPU	5254	169910	175164
Iter 20: InceptionV4/InceptionV4/Mixed_5b/Branch_1/Conv2d_0b_3x3/Conv2D	Convolution	OpenCL	8961	168910	177871
Iter 21: InceptionV4/InceptionV4/Mixed_5b/Branch_2/Conv2d_0c_3x3/Conv2D	Convolution	CPU	6609	175361	181970
Iter 22: InceptionV4/InceptionV4/Mixed_5b/Branch_3/AvgPool_0a_3x3/AvgPool	Pooling	CPU	1868	182187	184055
Iter 23: InceptionV4/InceptionV4/Mixed_5b/Branch_3/Conv2d_0b_1x1/Conv2D	Convolution	CPU	3881	184195	188076
Iter 24: InceptionV4/InceptionV4/Mixed_5b/concat	Concat	CPU	1435	188201	189636
Iter 25: InceptionV4/InceptionV4/Mixed_5c/Branch_0/Conv2d_0a_1x1/Conv2D	Convolution	CPU	4004	189704	193708
Iter 26: InceptionV4/InceptionV4/Mixed_5c/Branch_3/AvgPool_0a_3x3/AvgPool	Pooling	OpenCL	6125	189804	195929
Iter 27: InceptionV4/InceptionV4/Mixed_5c/Branch_1/Conv2d_0a_1x1/Conv2D	Convolution	CPU	3003	193886	196889
Iter 28: InceptionV4/InceptionV4/Mixed_5c/Branch_1/Conv2d_0b_3x3/Conv2D	Convolution	CPU	4027	196992	201019
Iter 29: InceptionV4/InceptionV4/Mixed_5c/Branch_3/Conv2d_0b_1x1/Conv2D	Convolution	OpenCL	6297	196047	202344
Iter 30: InceptionV4/InceptionV4/Mixed_5c/Branch_2/Conv2d_0a_1x1/Conv2D	Convolution	CPU	2778	201152	203930
Iter 31: InceptionV4/InceptionV4/Mixed_5c/Branch_2/Conv2d_0b_3x3/Conv2D	Convolution	CPU	3831	204039	207870
Iter 32: InceptionV4/InceptionV4/Mixed_5c/Branch_2/Conv2d_0c_3x3/Conv2D	Convolution	CPU	5517	208129	213646
Iter 33: InceptionV4/InceptionV4/Mixed_5c/concat	Concat	CPU	1360	213878	215238
Iter 34: InceptionV4/InceptionV4/Mixed_5d/Branch_0/Conv2d_0a_1x1/Conv2D	Convolution	CPU	4054	215308	219362
Iter 35: InceptionV4/InceptionV4/Mixed_5d/Branch_3/AvgPool_0a_3x3/AvgPool	Pooling	OpenCL	6366	215396	221762
Iter 36: InceptionV4/InceptionV4/Mixed_5d/Branch_1/Conv2d_0a_1x1/Conv2D	Convolution	CPU	2881	219529	222410
Iter 37: InceptionV4/InceptionV4/Mixed_5d/Branch_1/Conv2d_0b_3x3/Conv2D	Convolution	CPU	3989	222511	226500
Iter 38: InceptionV4/InceptionV4/Mixed_5d/Branch_3/Conv2d_0b_1x1/Conv2D	Convolution	OpenCL	6827	221861	228688
Iter 39: InceptionV4/InceptionV4/Mixed_5d/Branch_2/Conv2d_0a_1x1/Conv2D	Convolution	CPU	2764	226631	229395
Iter 40: InceptionV4/InceptionV4/Mixed_5d/Branch_2/Conv2d_0b_3x3/Conv2D	Convolution	CPU	3826	229497	233323
Iter 41: InceptionV4/InceptionV4/Mixed_5d/Branch_2/Conv2d_0c_3x3/Conv2D	Convolution	CPU	5584	233594	239178
Iter 42: InceptionV4/InceptionV4/Mixed_5d/concat	Concat	CPU	1434	239340	240774
Iter 43: InceptionV4/InceptionV4/Mixed_5e/Branch_0/Conv2d_0a_1x1/Conv2D	Convolution	CPU	4093	240951	245044
Iter 44: InceptionV4/InceptionV4/Mixed_5e/Branch_3/AvgPool_0a_3x3/AvgPool	Pooling	OpenCL	6178	240889	247067
Iter 45: InceptionV4/InceptionV4/Mixed_5e/Branch_1/Conv2d_0a_1x1/Conv2D	Convolution	CPU	2892	245212	248104
Iter 46: InceptionV4/InceptionV4/Mixed_5e/Branch_1/Conv2d_0b_3x3/Conv2D	Convolution	CPU	3950	248207	252157
Iter 47: InceptionV4/InceptionV4/Mixed_5e/Branch_3/Conv2d_0b_1x1/Conv2D	Convolution	OpenCL	6245	247182	253427
Iter 48: InceptionV4/InceptionV4/Mixed_5e/Branch_2/Conv2d_0a_1x1/Conv2D	Convolution	CPU	2765	252303	255068
Iter 49: InceptionV4/InceptionV4/Mixed_5e/Branch_2/Conv2d_0b_3x3/Conv2D	Convolution	CPU	3794	255176	258970
Iter 50: InceptionV4/InceptionV4/Mixed_5e/Branch_2/Conv2d_0c_3x3/Conv2D	Convolution	CPU	5552	259121	264673
Iter 51: InceptionV4/InceptionV4/Mixed_5e/concat	Concat	CPU	1469	264850	266319
Iter 52: InceptionV4/InceptionV4/Mixed_6a/Branch_1/Conv2d_0a_1x1/Conv2D	Convolution	CPU	7549	266382	273931
Iter 53: InceptionV4/InceptionV4/Mixed_6a/Branch_1/Conv2d_0b_3x3/Conv2D	Convolution	CPU	27079	274087	301166
Iter 54: InceptionV4/InceptionV4/Mixed_6a/Branch_1/Conv2d_1a_3x3/Conv2D	Convolution	CPU	17068	301319	318387
Iter 55: InceptionV4/InceptionV4/Mixed_6a/Branch_2/MaxPool_1a_3x3/MaxPool	Pooling	CPU	787	318514	319301
Iter 56: InceptionV4/InceptionV4/Mixed_6a/Branch_0/Conv2d_1a_3x3/Conv2D	Convolution	OpenCL	72938	266480	339418
Iter 57: InceptionV4/InceptionV4/Mixed_6a/concat	Concat	CPU	20984	319412	340396
Iter 58: InceptionV4/InceptionV4/Mixed_6b/Branch_1/Conv2d_0a_1x1/Conv2D	Convolution	OpenCL	9292	340571	349863
Iter 59: InceptionV4/InceptionV4/Mixed_6b/Branch_0/Conv2d_0a_1x1/Conv2D	Convolution	CPU	13184	340452	353636
Iter 60: InceptionV4/InceptionV4/Mixed_6b/Branch_2/Conv2d_0a_1x1/Conv2D	Convolution	CPU	6879	353740	360619
Iter 61: InceptionV4/InceptionV4/Mixed_6b/Branch_1/Conv2d_0b_1x7/Conv2D	Convolution	OpenCL	16007	349973	365980
Iter 62: InceptionV4/InceptionV4/Mixed_6b/Branch_2/Conv2d_0b_7x1/Conv2D	Convolution	CPU	8267	360758	369025
Iter 63: InceptionV4/InceptionV4/Mixed_6b/Branch_2/Conv2d_0c_1x7/Conv2D	Convolution	CPU	8893	369138	378031
Iter 64: InceptionV4/InceptionV4/Mixed_6b/Branch_1/Conv2d_0c_7x1/Conv2D	Convolution	OpenCL	19577	366144	385721
Iter 65: InceptionV4/InceptionV4/Mixed_6b/Branch_2/Conv2d_0d_7x1/Conv2D	Convolution	CPU	12026	378177	390203
Iter 66: InceptionV4/InceptionV4/Mixed_6b/Branch_3/AvgPool_0a_3x3/AvgPool	Pooling	OpenCL	7603	385890	393493
Iter 67: InceptionV4/InceptionV4/Mixed_6b/Branch_3/Conv2d_0b_1x1/Conv2D	Convolution	OpenCL	5833	393625	399458
Iter 68: InceptionV4/InceptionV4/Mixed_6b/Branch_2/Conv2d_0e_1x7/Conv2D	Convolution	CPU	13283	390410	403693
Iter 69: InceptionV4/InceptionV4/Mixed_6b/concat	Concat	CPU	991	403841	404832
Iter 70: InceptionV4/InceptionV4/Mixed_6c/Branch_1/Conv2d_0a_1x1/Conv2D	Convolution	OpenCL	9192	405084	414276
Iter 71: InceptionV4/InceptionV4/Mixed_6c/Branch_0/Conv2d_0a_1x1/Conv2D	Convolution	CPU	13063	404896	417959
Iter 72: InceptionV4/InceptionV4/Mixed_6c/Branch_2/Conv2d_0a_1x1/Conv2D	Convolution	CPU	6742	418066	424808
Iter 73: InceptionV4/InceptionV4/Mixed_6c/Branch_1/Conv2d_0b_1x7/Conv2D	Convolution	OpenCL	15918	414390	430308
Iter 74: InceptionV4/InceptionV4/Mixed_6c/Branch_2/Conv2d_0b_7x1/Conv2D	Convolution	CPU	7999	424949	432948
Iter 75: InceptionV4/InceptionV4/Mixed_6c/Branch_2/Conv2d_0c_1x7/Conv2D	Convolution	CPU	8823	433053	441876
Iter 76: InceptionV4/InceptionV4/Mixed_6c/Branch_1/Conv2d_0c_7x1/Conv2D	Convolution	OpenCL	19677	430424	450101
Iter 77: InceptionV4/InceptionV4/Mixed_6c/Branch_2/Conv2d_0d_7x1/Conv2D	Convolution	CPU	11540	442019	453559
Iter 78: InceptionV4/InceptionV4/Mixed_6c/Branch_3/AvgPool_0a_3x3/AvgPool	Pooling	OpenCL	7376	450219	457595
Iter 79: InceptionV4/InceptionV4/Mixed_6c/Branch_3/Conv2d_0b_1x1/Conv2D	Convolution	OpenCL	5682	457705	463387
Iter 80: InceptionV4/InceptionV4/Mixed_6c/Branch_2/Conv2d_0e_1x7/Conv2D	Convolution	CPU	13776	453755	467531
Iter 81: InceptionV4/InceptionV4/Mixed_6c/concat	Concat	CPU	985	467666	468651
Iter 82: InceptionV4/InceptionV4/Mixed_6d/Branch_1/Conv2d_0a_1x1/Conv2D	Convolution	OpenCL	9318	468820	478138
Iter 83: InceptionV4/InceptionV4/Mixed_6d/Branch_0/Conv2d_0a_1x1/Conv2D	Convolution	CPU	12936	468707	481643
Iter 84: InceptionV4/InceptionV4/Mixed_6d/Branch_2/Conv2d_0a_1x1/Conv2D	Convolution	CPU	6691	481750	488441
Iter 85: InceptionV4/InceptionV4/Mixed_6d/Branch_1/Conv2d_0b_1x7/Conv2D	Convolution	OpenCL	15870	478248	494118
Iter 86: InceptionV4/InceptionV4/Mixed_6d/Branch_2/Conv2d_0b_7x1/Conv2D	Convolution	CPU	8069	488574	496643
Iter 87: InceptionV4/InceptionV4/Mixed_6d/Branch_2/Conv2d_0c_1x7/Conv2D	Convolution	CPU	8662	496750	505412
Iter 88: InceptionV4/InceptionV4/Mixed_6d/Branch_1/Conv2d_0c_7x1/Conv2D	Convolution	OpenCL	19810	494257	514067
Iter 89: InceptionV4/InceptionV4/Mixed_6d/Branch_2/Conv2d_0d_7x1/Conv2D	Convolution	CPU	11694	505553	517247
Iter 90: InceptionV4/InceptionV4/Mixed_6d/Branch_3/AvgPool_0a_3x3/AvgPool	Pooling	OpenCL	7262	514184	521446
Iter 91: InceptionV4/InceptionV4/Mixed_6d/Branch_3/Conv2d_0b_1x1/Conv2D	Convolution	OpenCL	5551	521582	527133
Iter 92: InceptionV4/InceptionV4/Mixed_6d/Branch_2/Conv2d_0e_1x7/Conv2D	Convolution	CPU	13787	517436	531223
Iter 93: InceptionV4/Logits/PreLogitsFlatten/flatten/strided_slice/stack	Const	CPU	1	531542	531543
Iter 94: InceptionV4/Logits/PreLogitsFlatten/flatten/strided_slice/stack_1	Const	CPU	1	531614	531615
Iter 95: InceptionV4/Logits/PreLogitsFlatten/flatten/strided_slice/stack_2	Const	CPU	0	531664	531664
Iter 96: InceptionV4/Logits/PreLogitsFlatten/flatten/Reshape/shape/1	Const	CPU	1	531732	531733
Iter 97: InceptionV4/Logits/Logits/weights	Const	CPU	0	531784	531784
Iter 98: InceptionV4/Logits/Logits/biases	Const	CPU	1	531847	531848
Iter 99: InceptionV4/InceptionV4/Mixed_6d/concat	Concat	OpenCL	2010	531462	533472
Iter 100: InceptionV4/InceptionV4/Mixed_6e/Branch_1/Conv2d_0a_1x1/Conv2D	Convolution	OpenCL	7677	533565	541242
Iter 101: InceptionV4/InceptionV4/Mixed_6e/Branch_0/Conv2d_0a_1x1/Conv2D	Convolution	CPU	21535	533627	555162
Iter 102: InceptionV4/InceptionV4/Mixed_6e/Branch_1/Conv2d_0b_1x7/Conv2D	Convolution	OpenCL	15639	541293	556932
Iter 103: InceptionV4/InceptionV4/Mixed_6e/Branch_2/Conv2d_0a_1x1/Conv2D	Convolution	CPU	8984	555319	564303
Iter 104: InceptionV4/InceptionV4/Mixed_6e/Branch_2/Conv2d_0b_7x1/Conv2D	Convolution	CPU	7886	564440	572326
Iter 105: InceptionV4/InceptionV4/Mixed_6e/Branch_1/Conv2d_0c_7x1/Conv2D	Convolution	OpenCL	20688	557006	577694
Iter 106: InceptionV4/InceptionV4/Mixed_6e/Branch_2/Conv2d_0c_1x7/Conv2D	Convolution	CPU	11153	572467	583620
Iter 107: InceptionV4/InceptionV4/Mixed_6e/Branch_3/AvgPool_0a_3x3/AvgPool	Pooling	OpenCL	6354	577829	584183
Iter 108: InceptionV4/InceptionV4/Mixed_6e/Branch_3/Conv2d_0b_1x1/Conv2D	Convolution	OpenCL	5892	584298	590190
Iter 109: InceptionV4/InceptionV4/Mixed_6e/Branch_2/Conv2d_0d_7x1/Conv2D	Convolution	CPU	10802	583794	594596
Iter 110: InceptionV4/InceptionV4/Mixed_6e/Branch_2/Conv2d_0e_1x7/Conv2D	Convolution	CPU	11327	594806	606133
Iter 111: InceptionV4/InceptionV4/Mixed_6e/concat	Concat	CPU	981	606287	607268
Iter 112: InceptionV4/InceptionV4/Mixed_6f/Branch_1/Conv2d_0a_1x1/Conv2D	Convolution	OpenCL	9264	607441	616705
Iter 113: InceptionV4/InceptionV4/Mixed_6f/Branch_0/Conv2d_0a_1x1/Conv2D	Convolution	CPU	13031	607343	620374
Iter 114: InceptionV4/InceptionV4/Mixed_6f/Branch_2/Conv2d_0a_1x1/Conv2D	Convolution	CPU	6756	620482	627238
Iter 115: InceptionV4/InceptionV4/Mixed_6f/Branch_1/Conv2d_0b_1x7/Conv2D	Convolution	OpenCL	16017	616834	632851
Iter 116: InceptionV4/InceptionV4/Mixed_6f/Branch_2/Conv2d_0b_7x1/Conv2D	Convolution	CPU	7950	627386	635336
Iter 117: InceptionV4/InceptionV4/Mixed_6f/Branch_2/Conv2d_0c_1x7/Conv2D	Convolution	CPU	8851	635443	644294
Iter 118: InceptionV4/InceptionV4/Mixed_6f/Branch_1/Conv2d_0c_7x1/Conv2D	Convolution	OpenCL	20243	632966	653209
Iter 119: InceptionV4/InceptionV4/Mixed_6f/Branch_2/Conv2d_0d_7x1/Conv2D	Convolution	CPU	11694	644442	656136
Iter 120: InceptionV4/InceptionV4/Mixed_6f/Branch_3/AvgPool_0a_3x3/AvgPool	Pooling	OpenCL	7545	653328	660873
Iter 121: InceptionV4/InceptionV4/Mixed_6f/Branch_3/Conv2d_0b_1x1/Conv2D	Convolution	OpenCL	5611	661026	666637
Iter 122: InceptionV4/InceptionV4/Mixed_6f/Branch_2/Conv2d_0e_1x7/Conv2D	Convolution	CPU	13987	656309	670296
Iter 123: InceptionV4/InceptionV4/Mixed_6f/concat	Concat	OpenCL	2083	670488	672571
Iter 124: InceptionV4/InceptionV4/Mixed_6g/Branch_1/Conv2d_0a_1x1/Conv2D	Convolution	OpenCL	8540	672633	681173
Iter 125: InceptionV4/InceptionV4/Mixed_6g/Branch_0/Conv2d_0a_1x1/Conv2D	Convolution	CPU	21297	672725	694022
Iter 126: InceptionV4/InceptionV4/Mixed_6g/Branch_1/Conv2d_0b_1x7/Conv2D	Convolution	OpenCL	16456	681250	697706
Iter 127: InceptionV4/InceptionV4/Mixed_6g/Branch_2/Conv2d_0a_1x1/Conv2D	Convolution	CPU	10245	694182	704427
Iter 128: InceptionV4/InceptionV4/Mixed_6g/Branch_2/Conv2d_0b_7x1/Conv2D	Convolution	CPU	7970	704587	712557
Iter 129: InceptionV4/InceptionV4/Mixed_6g/Branch_1/Conv2d_0c_7x1/Conv2D	Convolution	OpenCL	20052	697833	717885
Iter 130: InceptionV4/InceptionV4/Mixed_6g/Branch_2/Conv2d_0c_1x7/Conv2D	Convolution	CPU	11455	712770	724225
Iter 131: InceptionV4/InceptionV4/Mixed_6g/Branch_3/AvgPool_0a_3x3/AvgPool	Pooling	OpenCL	6333	718004	724337
Iter 132: InceptionV4/InceptionV4/Mixed_6g/Branch_3/Conv2d_0b_1x1/Conv2D	Convolution	OpenCL	5726	724550	730276
Iter 133: InceptionV4/InceptionV4/Mixed_6g/Branch_2/Conv2d_0d_7x1/Conv2D	Convolution	CPU	10658	724458	735116
Iter 134: InceptionV4/InceptionV4/Mixed_6g/Branch_2/Conv2d_0e_1x7/Conv2D	Convolution	CPU	11387	735342	746729
Iter 135: InceptionV4/InceptionV4/Mixed_6g/concat	Concat	OpenCL	2119	747018	749137
Iter 136: InceptionV4/InceptionV4/Mixed_6h/Branch_1/Conv2d_0a_1x1/Conv2D	Convolution	OpenCL	8535	749203	757738
Iter 137: InceptionV4/InceptionV4/Mixed_6h/Branch_0/Conv2d_0a_1x1/Conv2D	Convolution	CPU	22221	749292	771513
Iter 138: InceptionV4/InceptionV4/Mixed_6h/Branch_1/Conv2d_0b_1x7/Conv2D	Convolution	OpenCL	16414	757789	774203
Iter 139: InceptionV4/InceptionV4/Mixed_6h/Branch_2/Conv2d_0a_1x1/Conv2D	Convolution	CPU	9164	771669	780833
Iter 140: InceptionV4/InceptionV4/Mixed_6h/Branch_2/Conv2d_0b_7x1/Conv2D	Convolution	CPU	7837	780984	788821
Iter 141: InceptionV4/InceptionV4/Mixed_6h/Branch_1/Conv2d_0c_7x1/Conv2D	Convolution	OpenCL	19840	774335	794175
Iter 142: InceptionV4/InceptionV4/Mixed_6h/Branch_2/Conv2d_0c_1x7/Conv2D	Convolution	CPU	11359	788965	800324
Iter 143: InceptionV4/InceptionV4/Mixed_6h/Branch_3/AvgPool_0a_3x3/AvgPool	Pooling	OpenCL	6301	794305	800606
Iter 144: InceptionV4/InceptionV4/Mixed_6h/Branch_3/Conv2d_0b_1x1/Conv2D	Convolution	OpenCL	5697	800749	806446
Iter 145: InceptionV4/InceptionV4/Mixed_6h/Branch_2/Conv2d_0d_7x1/Conv2D	Convolution	CPU	10620	800452	811072
Iter 146: InceptionV4/InceptionV4/Mixed_6h/Branch_2/Conv2d_0e_1x7/Conv2D	Convolution	CPU	11333	811268	822601
Iter 147: InceptionV4/InceptionV4/Mixed_6h/concat	Concat	OpenCL	2006	822804	824810
Iter 148: InceptionV4/InceptionV4/Mixed_7a/Branch_0/Conv2d_0a_1x1/Conv2D	Convolution	OpenCL	8341	824874	833215
Iter 149: InceptionV4/InceptionV4/Mixed_7a/Branch_0/Conv2d_1a_3x3/Conv2D	Convolution	OpenCL	4258	833283	837541
Iter 150: InceptionV4/InceptionV4/Mixed_7a/Branch_2/MaxPool_1a_3x3/MaxPool	Pooling	OpenCL	2278	837658	839936
Iter 151: InceptionV4/InceptionV4/Mixed_7a/Branch_1/Conv2d_0a_1x1/Conv2D	Convolution	CPU	18213	824970	843183
Iter 152: InceptionV4/InceptionV4/Mixed_7a/Branch_1/Conv2d_0b_1x7/Conv2D	Convolution	CPU	13244	843313	856557
Iter 153: InceptionV4/InceptionV4/Mixed_7a/Branch_1/Conv2d_0c_7x1/Conv2D	Convolution	CPU	16993	856718	873711
Iter 154: InceptionV4/InceptionV4/Mixed_7a/Branch_1/Conv2d_1a_3x3/Conv2D	Convolution	CPU	8222	873950	882172
Iter 155: InceptionV4/InceptionV4/Mixed_7a/concat	Concat	CPU	468	882403	882871
Iter 156: InceptionV4/InceptionV4/Mixed_7b/Branch_0/Conv2d_0a_1x1/Conv2D	Convolution	OpenCL	3956	883124	887080
Iter 157: InceptionV4/InceptionV4/Mixed_7b/Branch_2/Conv2d_0a_1x1/Conv2D	Convolution	CPU	4960	882919	887879
Iter 158: InceptionV4/InceptionV4/Mixed_7b/Branch_1/Conv2d_0a_1x1/Conv2D	Convolution	OpenCL	5515	887190	892705
Iter 159: InceptionV4/InceptionV4/Mixed_7b/Branch_2/Conv2d_0b_3x1/Conv2D	Convolution	CPU	4747	887983	892730
Iter 160: InceptionV4/InceptionV4/Mixed_7b/Branch_1/Conv2d_0b_1x3/Conv2D	Convolution	OpenCL	3812	892827	896639
Iter 161: InceptionV4/InceptionV4/Mixed_7b/Branch_2/Conv2d_0c_1x3/Conv2D	Convolution	CPU	6805	892897	899702
Iter 162: InceptionV4/InceptionV4/Mixed_7b/Branch_1/Conv2d_0c_3x1/Conv2D	Convolution	OpenCL	3592	896776	900368
Iter 163: InceptionV4/InceptionV4/Mixed_7b/Branch_1/concat	Concat	OpenCL	1373	900449	901822
Iter 164: InceptionV4/InceptionV4/Mixed_7b/Branch_2/Conv2d_0d_1x3/Conv2D	Convolution	CPU	4061	899819	903880
Iter 165: InceptionV4/InceptionV4/Mixed_7b/Branch_3/AvgPool_0a_3x3/AvgPool	Pooling	OpenCL	2751	901934	904685
Iter 166: InceptionV4/InceptionV4/Mixed_7b/Branch_2/Conv2d_0e_3x1/Conv2D	Convolution	CPU	3929	904018	907947
Iter 167: InceptionV4/InceptionV4/Mixed_7b/Branch_3/Conv2d_0b_1x1/Conv2D	Convolution	OpenCL	3290	904801	908091
Iter 168: InceptionV4/InceptionV4/Mixed_7b/Branch_2/concat	Concat	CPU	101	908078	908179
Iter 169: InceptionV4/InceptionV4/Mixed_7b/concat	Concat	CPU	394	908246	908640
Iter 170: InceptionV4/InceptionV4/Mixed_7c/Branch_0/Conv2d_0a_1x1/Conv2D	Convolution	CPU	3534	908780	912314
Iter 171: InceptionV4/InceptionV4/Mixed_7c/Branch_1/Conv2d_0a_1x1/Conv2D	Convolution	OpenCL	5437	908733	914170
Iter 172: InceptionV4/InceptionV4/Mixed_7c/Branch_2/Conv2d_0a_1x1/Conv2D	Convolution	CPU	5394	912446	917840
Iter 173: InceptionV4/InceptionV4/Mixed_7c/Branch_1/Conv2d_0b_1x3/Conv2D	Convolution	OpenCL	4008	914274	918282
Iter 174: InceptionV4/InceptionV4/Mixed_7c/Branch_1/Conv2d_0c_3x1/Conv2D	Convolution	OpenCL	3746	918376	922122
Iter 175: InceptionV4/InceptionV4/Mixed_7c/Branch_2/Conv2d_0b_3x1/Conv2D	Convolution	CPU	4911	917962	922873
Iter 176: InceptionV4/InceptionV4/Mixed_7c/Branch_1/concat	Concat	OpenCL	1424	922225	923649
Iter 177: InceptionV4/InceptionV4/Mixed_7c/Branch_3/AvgPool_0a_3x3/AvgPool	Pooling	OpenCL	3029	923744	926773
Iter 178: InceptionV4/InceptionV4/Mixed_7c/Branch_2/Conv2d_0c_1x3/Conv2D	Convolution	CPU	6986	922955	929941
Iter 179: InceptionV4/InceptionV4/Mixed_7c/Branch_3/Conv2d_0b_1x1/Conv2D	Convolution	OpenCL	3276	926914	930190
Iter 180: InceptionV4/InceptionV4/Mixed_7c/Branch_2/Conv2d_0d_1x3/Conv2D	Convolution	CPU	3349	930027	933376
Iter 181: InceptionV4/InceptionV4/Mixed_7c/Branch_2/Conv2d_0e_3x1/Conv2D	Convolution	CPU	3412	933522	936934
Iter 182: InceptionV4/InceptionV4/Mixed_7c/Branch_2/concat	Concat	CPU	139	937056	937195
Iter 183: InceptionV4/InceptionV4/Mixed_7c/concat	Concat	CPU	342	937250	937592
Iter 184: InceptionV4/InceptionV4/Mixed_7d/Branch_0/Conv2d_0a_1x1/Conv2D	Convolution	CPU	3438	937640	941078
Iter 185: InceptionV4/InceptionV4/Mixed_7d/Branch_1/Conv2d_0a_1x1/Conv2D	Convolution	OpenCL	5623	937806	943429
Iter 186: InceptionV4/InceptionV4/Mixed_7d/Branch_2/Conv2d_0a_1x1/Conv2D	Convolution	CPU	5159	941209	946368
Iter 187: InceptionV4/InceptionV4/Mixed_7d/Branch_1/Conv2d_0b_1x3/Conv2D	Convolution	OpenCL	4599	943546	948145
Iter 188: InceptionV4/InceptionV4/Mixed_7d/Branch_2/Conv2d_0b_3x1/Conv2D	Convolution	CPU	5074	946495	951569
Iter 189: InceptionV4/InceptionV4/Mixed_7d/Branch_1/Conv2d_0c_3x1/Conv2D	Convolution	OpenCL	3716	948248	951964
Iter 190: InceptionV4/InceptionV4/Mixed_7d/Branch_1/concat	Concat	OpenCL	1426	952046	953472
Iter 191: InceptionV4/InceptionV4/Mixed_7d/Branch_3/AvgPool_0a_3x3/AvgPool	Pooling	OpenCL	2843	953568	956411
Iter 192: InceptionV4/InceptionV4/Mixed_7d/Branch_2/Conv2d_0c_1x3/Conv2D	Convolution	CPU	7189	951668	958857
Iter 193: InceptionV4/InceptionV4/Mixed_7d/Branch_3/Conv2d_0b_1x1/Conv2D	Convolution	OpenCL	3365	956506	959871
Iter 194: InceptionV4/InceptionV4/Mixed_7d/Branch_2/Conv2d_0d_1x3/Conv2D	Convolution	CPU	3426	958946	962372
Iter 195: InceptionV4/InceptionV4/Mixed_7d/Branch_2/Conv2d_0e_3x1/Conv2D	Convolution	CPU	3352	962469	965821
Iter 196: InceptionV4/InceptionV4/Mixed_7d/Branch_2/concat	Concat	CPU	76	965948	966024
Iter 197: InceptionV4/InceptionV4/Mixed_7d/concat	Concat	CPU	362	966117	966479
Iter 198: InceptionV4/Logits/AvgPool_1a/AvgPool	Pooling	CPU	157	966526	966683
Iter 199: InceptionV4/Logits/PreLogitsFlatten/flatten/Shape	Shape	CPU	1	966754	966755
Iter 200: InceptionV4/Logits/PreLogitsFlatten/flatten/strided_slice	StridedSlice	CPU	1	966807	966808
Iter 201: InceptionV4/Logits/PreLogitsFlatten/flatten/Reshape/shape	Pack	CPU	1	966852	966853
Iter 202: InceptionV4/Logits/AvgPool_1a/AvgPool___tr4InceptionV4/Logits/PreLogitsFlatten/flatten/Reshape	ConvertTensor	CPU	6	966900	966906
Iter 203: InceptionV4/Logits/PreLogitsFlatten/flatten/Reshape	Reshape	CPU	3	966950	966953
Iter 204: InceptionV4/Logits/Logits/MatMul	MatMul	CPU	15247	966991	982238
Iter 205: InceptionV4/Logits/Logits/BiasAdd	BinaryOp	CPU	31	982348	982379
Iter 206: InceptionV4/Logits/Predictions	Softmax	CPU	20	982420	982440
Iter 0: InceptionV4/InceptionV4/Conv2d_1a_3x3/Conv2D	Convolution	CPU	4033	371	4404
Iter 1: InceptionV4/InceptionV4/Conv2d_2a_3x3/Conv2D	Convolution	CPU	11098	4594	15692
Iter 2: InceptionV4/InceptionV4/Conv2d_2b_3x3/Conv2D	Convolution	CPU	21336	15898	37234
Iter 3: InceptionV4/InceptionV4/Mixed_3a/Branch_0/MaxPool_0a_3x3/MaxPool	Pooling	CPU	1549	37463	39012
Iter 4: InceptionV4/InceptionV4/Mixed_3a/Branch_1/Conv2d_0a_3x3/Conv2D	Convolution	CPU	27483	39125	66608
Iter 5: InceptionV4/InceptionV4/Mixed_3a/concat	Concat	CPU	1799	66792	68591
Iter 6: InceptionV4/InceptionV4/Mixed_4a/Branch_1/Conv2d_0a_1x1/Conv2D	Convolution	CPU	4727	68654	73381
Iter 7: InceptionV4/InceptionV4/Mixed_4a/Branch_0/Conv2d_0a_1x1/Conv2D	Convolution	OpenCL	13367	68810	82177
Iter 8: InceptionV4/InceptionV4/Mixed_4a/Branch_1/Conv2d_0b_1x7/Conv2D	Convolution	CPU	14517	73505	88022
Iter 9: InceptionV4/InceptionV4/Mixed_4a/Branch_1/Conv2d_0c_7x1/Conv2D	Convolution	CPU	15925	88241	104166
Iter 10: InceptionV4/InceptionV4/Mixed_4a/Branch_0/Conv2d_1a_3x3/Conv2D	Convolution	OpenCL	29027	82274	111301
Iter 11: InceptionV4/InceptionV4/Mixed_4a/Branch_1/Conv2d_1a_3x3/Conv2D	Convolution	CPU	14862	104411	119273
Iter 12: InceptionV4/InceptionV4/Mixed_4a/concat	Concat	CPU	2898	119553	122451
Iter 13: InceptionV4/InceptionV4/Mixed_5a/Branch_0/Conv2d_1a_3x3/Conv2D	Convolution	CPU	37200	122507	159707
Iter 14: InceptionV4/InceptionV4/Mixed_5a/Branch_1/MaxPool_1a_3x3/MaxPool	Pooling	CPU	1283	159988	161271
Iter 15: InceptionV4/InceptionV4/Mixed_5a/concat	Concat	CPU	1068	161371	162439
Iter 16: InceptionV4/InceptionV4/Mixed_5b/Branch_0/Conv2d_0a_1x1/Conv2D	Convolution	CPU	3829	162497	166326
Iter 17: InceptionV4/InceptionV4/Mixed_5b/Branch_1/Conv2d_0a_1x1/Conv2D	Convolution	OpenCL	5729	162649	168378
Iter 18: InceptionV4/InceptionV4/Mixed_5b/Branch_2/Conv2d_0a_1x1/Conv2D	Convolution	CPU	2708	166470	169178
Iter 19: InceptionV4/InceptionV4/Mixed_5b/Branch_2/Conv2d_0b_3x3/Conv2D	Convolution	CPU	5406	169280	174686
Iter 20: InceptionV4/InceptionV4/Mixed_5b/Branch_1/Conv2d_0b_3x3/Conv2D	Convolution	OpenCL	9014	168536	177550
Iter 21: InceptionV4/InceptionV4/Mixed_5b/Branch_2/Conv2d_0c_3x3/Conv2D	Convolution	CPU	6524	174894	181418
Iter 22: InceptionV4/InceptionV4/Mixed_5b/Branch_3/AvgPool_0a_3x3/AvgPool	Pooling	CPU	1915	181560	183475
Iter 23: InceptionV4/InceptionV4/Mixed_5b/Branch_3/Conv2d_0b_1x1/Conv2D	Convolution	CPU	3773	183580	187353
Iter 24: InceptionV4/InceptionV4/Mixed_5b/concat	Concat	CPU	1329	187480	188809
Iter 25: InceptionV4/InceptionV4/Mixed_5c/Branch_0/Conv2d_0a_1x1/Conv2D	Convolution	CPU	4033	188863	192896
Iter 26: InceptionV4/InceptionV4/Mixed_5c/Branch_3/AvgPool_0a_3x3/AvgPool	Pooling	OpenCL	5913	188990	194903
Iter 27: InceptionV4/InceptionV4/Mixed_5c/Branch_1/Conv2d_0a_1x1/Conv2D	Convolution	CPU	2853	193063	195916
Iter 28: InceptionV4/InceptionV4/Mixed_5c/Branch_1/Conv2d_0b_3x3/Conv2D	Convolution	CPU	3996	196003	199999
Iter 29: InceptionV4/InceptionV4/Mixed_5c/Branch_3/Conv2d_0b_1x1/Conv2D	Convolution	OpenCL	6177	194998	201175
Iter 30: InceptionV4/InceptionV4/Mixed_5c/Branch_2/Conv2d_0a_1x1/Conv2D	Convolution	CPU	2771	200135	202906
Iter 31: InceptionV4/InceptionV4/Mixed_5c/Branch_2/Conv2d_0b_3x3/Conv2D	Convolution	CPU	3665	203010	206675
Iter 32: InceptionV4/InceptionV4/Mixed_5c/Branch_2/Conv2d_0c_3x3/Conv2D	Convolution	CPU	5591	206853	212444
Iter 33: InceptionV4/InceptionV4/Mixed_5c/concat	Concat	CPU	1293	212642	213935
Iter 34: InceptionV4/InceptionV4/Mixed_5d/Branch_0/Conv2d_0a_1x1/Conv2D	Convolution	CPU	3995	213992	217987
Iter 35: InceptionV4/InceptionV4/Mixed_5d/Branch_3/AvgPool_0a_3x3/AvgPool	Pooling	OpenCL	5935	214173	220108
Iter 36: InceptionV4/InceptionV4/Mixed_5d/Branch_1/Conv2d_0a_1x1/Conv2D	Convolution	CPU	2858	218152	221010
Iter 37: InceptionV4/InceptionV4/Mixed_5d/Branch_1/Conv2d_0b_3x3/Conv2D	Convolution	CPU	3946	221101	225047
Iter 38: InceptionV4/InceptionV4/Mixed_5d/Branch_3/Conv2d_0b_1x1/Conv2D	Convolution	OpenCL	6974	220202	227176
Iter 39: InceptionV4/InceptionV4/Mixed_5d/Branch_2/Conv2d_0a_1x1/Conv2D	Convolution	CPU	2748	225193	227941
Iter 40: InceptionV4/InceptionV4/Mixed_5d/Branch_2/Conv2d_0b_3x3/Conv2D	Convolution	CPU	3835	228033	231868
Iter 41: InceptionV4/InceptionV4/Mixed_5d/Branch_2/Conv2d_0c_3x3/Conv2D	Convolution	CPU	5488	231994	237482
Iter 42: InceptionV4/InceptionV4/Mixed_5d/concat	Concat	CPU	1291	237768	239059
Iter 43: InceptionV4/InceptionV4/Mixed_5e/Branch_0/Conv2d_0a_1x1/Conv2D	Convolution	CPU	4092	239127	243219
Iter 44: InceptionV4/InceptionV4/Mixed_5e/Branch_3/AvgPool_0a_3x3/AvgPool	Pooling	OpenCL	5948	239283	245231
Iter 45: InceptionV4/InceptionV4/Mixed_5e/Branch_1/Conv2d_0a_1x1/Conv2D	Convolution	CPU	2848	243373	246221
Iter 46: InceptionV4/InceptionV4/Mixed_5e/Branch_1/Conv2d_0b_3x3/Conv2D	Convolution	CPU	3974	246306	250280
Iter 47: InceptionV4/InceptionV4/Mixed_5e/Branch_3/Conv2d_0b_1x1/Conv2D	Convolution	OpenCL	6298	245354	251652
Iter 48: InceptionV4/InceptionV4/Mixed_5e/Branch_2/Conv2d_0a_1x1/Conv2D	Convolution	CPU	2861	250426	253287
Iter 49: InceptionV4/InceptionV4/Mixed_5e/Branch_2/Conv2d_0b_3x3/Conv2D	Convolution	CPU	3719	253403	257122
Iter 50: InceptionV4/InceptionV4/Mixed_5e/Branch_2/Conv2d_0c_3x3/Conv2D	Convolution	CPU	5712	257279	262991
Iter 51: InceptionV4/InceptionV4/Mixed_5e/concat	Concat	CPU	1365	263131	264496
Iter 52: InceptionV4/InceptionV4/Mixed_6a/Branch_1/Conv2d_0a_1x1/Conv2D	Convolution	CPU	7731	264555	272286
Iter 53: InceptionV4/InceptionV4/Mixed_6a/Branch_1/Conv2d_0b_3x3/Conv2D	Convolution	CPU	27929	272425	300354
Iter 54: InceptionV4/InceptionV4/Mixed_6a/Branch_1/Conv2d_1a_3x3/Conv2D	Convolution	CPU	17427	300494	317921
Iter 55: InceptionV4/InceptionV4/Mixed_6a/Branch_2/MaxPool_1a_3x3/MaxPool	Pooling	CPU	826	318055	318881
Iter 56: InceptionV4/InceptionV4/Mixed_6a/Branch_0/Conv2d_1a_3x3/Conv2D	Convolution	OpenCL	73328	264721	338049
Iter 57: InceptionV4/InceptionV4/Mixed_6a/concat	Concat	CPU	20173	318999	339172
Iter 58: InceptionV4/InceptionV4/Mixed_6b/Branch_1/Conv2d_0a_1x1/Conv2D	Convolution	OpenCL	9681	339419	349100
Iter 59: InceptionV4/InceptionV4/Mixed_6b/Branch_0/Conv2d_0a_1x1/Conv2D	Convolution	CPU	13552	339223	352775
Iter 60: InceptionV4/InceptionV4/Mixed_6b/Branch_2/Conv2d_0a_1x1/Conv2D	Convolution	CPU	6982	352886	359868
Iter 61: InceptionV4/InceptionV4/Mixed_6b/Branch_1/Conv2d_0b_1x7/Conv2D	Convolution	OpenCL	16028	349197	365225
Iter 62: InceptionV4/InceptionV4/Mixed_6b/Branch_2/Conv2d_0b_7x1/Conv2D	Convolution	CPU	8316	360002	368318
Iter 63: InceptionV4/InceptionV4/Mixed_6b/Branch_2/Conv2d_0c_1x7/Conv2D	Convolution	CPU	9171	368434	377605
Iter 64: InceptionV4/InceptionV4/Mixed_6b/Branch_1/Conv2d_0c_7x1/Conv2D	Convolution	OpenCL	19778	365330	385108
Iter 65: InceptionV4/InceptionV4/Mixed_6b/Branch_2/Conv2d_0d_7x1/Conv2D	Convolution	CPU	12501	377746	390247
Iter 66: InceptionV4/InceptionV4/Mixed_6b/Branch_3/AvgPool_0a_3x3/AvgPool	Pooling	OpenCL	8257	385303	393560
Iter 67: InceptionV4/InceptionV4/Mixed_6b/Branch_3/Conv2d_0b_1x1/Conv2D	Convolution	OpenCL	5735	393701	399436
Iter 68: InceptionV4/InceptionV4/Mixed_6b/Branch_2/Conv2d_0e_1x7/Conv2D	Convolution	CPU	13051	390460	403511
Iter 69: InceptionV4/InceptionV4/Mixed_6b/concat	Concat	CPU	949	403655	404604
Iter 70: InceptionV4/InceptionV4/Mixed_6c/Branch_1/Conv2d_0a_1x1/Conv2D	Convolution	OpenCL	9272	404826	414098
Iter 71: InceptionV4/InceptionV4/Mixed_6c/Branch_0/Conv2d_0a_1x1/Conv2D	Convolution	CPU	13097	404662	417759
Iter 72: InceptionV4/InceptionV4/Mixed_6c/Branch_2/Conv2d_0a_1x1/Conv2D	Convolution	CPU	6910	417856	424766
Iter 73: InceptionV4/InceptionV4/Mixed_6c/Branch_1/Conv2d_0b_1x7/Conv2D	Convolution	OpenCL	15863	414208	430071
Iter 74: InceptionV4/InceptionV4/Mixed_6c/Branch_2/Conv2d_0b_7x1/Conv2D	Convolution	CPU	8081	424899	432980
Iter 75: InceptionV4/InceptionV4/Mixed_6c/Branch_2/Conv2d_0c_1x7/Conv2D	Convolution	CPU	8796	433083	441879
Iter 76: InceptionV4/InceptionV4/Mixed_6c/Branch_1/Conv2d_0c_7x1/Conv2D	Convolution	OpenCL	19592	430192	449784
Iter 77: InceptionV4/InceptionV4/Mixed_6c/Branch_2/Conv2d_0d_7x1/Conv2D	Convolution	CPU	11752	442007	453759
Iter 78: InceptionV4/InceptionV4/Mixed_6c/Branch_3/AvgPool_0a_3x3/AvgPool	Pooling	OpenCL	7475	449913	457388
Iter 79: InceptionV4/InceptionV4/Mixed_6c/Branch_3/Conv2d_0b_1x1/Conv2D	Convolution	OpenCL	5591	457495	463086
Iter 80: InceptionV4/InceptionV4/Mixed_6c/Branch_2/Conv2d_0e_1x7/Conv2D	Convolution	CPU	13484	453941	467425
Iter 81: InceptionV4/InceptionV4/Mixed_6c/concat	Concat	CPU	947	467591	468538
Iter 82: InceptionV4/InceptionV4/Mixed_6d/Branch_1/Conv2d_0a_1x1/Conv2D	Convolution	OpenCL	9281	468762	478043
Iter 83: InceptionV4/InceptionV4/Mixed_6d/Branch_0/Conv2d_0a_1x1/Conv2D	Convolution	CPU	13067	468593	481660
Iter 84: InceptionV4/InceptionV4/Mixed_6d/Branch_2/Conv2d_0a_1x1/Conv2D	Convolution	CPU	6625	481813	488438
Iter 85: InceptionV4/InceptionV4/Mixed_6d/Branch_1/Conv2d_0b_1x7/Conv2D	Convolution	OpenCL	15981	478153	494134
Iter 86: InceptionV4/InceptionV4/Mixed_6d/Branch_2/Conv2d_0b_7x1/Conv2D	Convolution	CPU	8030	488573	496603
Iter 87: InceptionV4/InceptionV4/Mixed_6d/Branch_2/Conv2d_0c_1x7/Conv2D	Convolution	CPU	8786	496705	505491
Iter 88: InceptionV4/InceptionV4/Mixed_6d/Branch_1/Conv2d_0c_7x1/Conv2D	Convolution	OpenCL	19777	494277	514054
Iter 89: InceptionV4/InceptionV4/Mixed_6d/Branch_2/Conv2d_0d_7x1/Conv2D	Convolution	CPU	11708	505630	517338
Iter 90: InceptionV4/InceptionV4/Mixed_6d/Branch_3/AvgPool_0a_3x3/AvgPool	Pooling	OpenCL	7359	514181	521540
Iter 91: InceptionV4/InceptionV4/Mixed_6d/Branch_3/Conv2d_0b_1x1/Conv2D	Convolution	OpenCL	5731	521657	527388
Iter 92: InceptionV4/InceptionV4/Mixed_6d/Branch_2/Conv2d_0e_1x7/Conv2D	Convolution	CPU	13803	517535	531338
Iter 93: InceptionV4/Logits/PreLogitsFlatten/flatten/strided_slice/stack	Const	CPU	0	531579	531579
Iter 94: InceptionV4/Logits/PreLogitsFlatten/flatten/strided_slice/stack_1	Const	CPU	1	531644	531645
Iter 95: InceptionV4/Logits/PreLogitsFlatten/flatten/strided_slice/stack_2	Const	CPU	0	531699	531699
Iter 96: InceptionV4/Logits/PreLogitsFlatten/flatten/Reshape/shape/1	Const	CPU	1	531756	531757
Iter 97: InceptionV4/Logits/Logits/weights	Const	CPU	1	531860	531861
Iter 98: InceptionV4/Logits/Logits/biases	Const	CPU	0	531926	531926
Iter 99: InceptionV4/InceptionV4/Mixed_6d/concat	Concat	OpenCL	2046	531540	533586
Iter 100: InceptionV4/InceptionV4/Mixed_6e/Branch_1/Conv2d_0a_1x1/Conv2D	Convolution	OpenCL	7745	533663	541408
Iter 101: InceptionV4/InceptionV4/Mixed_6e/Branch_0/Conv2d_0a_1x1/Conv2D	Convolution	CPU	21613	533735	555348
Iter 102: InceptionV4/InceptionV4/Mixed_6e/Branch_1/Conv2d_0b_1x7/Conv2D	Convolution	OpenCL	16292	541460	557752
Iter 103: InceptionV4/InceptionV4/Mixed_6e/Branch_2/Conv2d_0a_1x1/Conv2D	Convolution	CPU	8975	555491	564466
Iter 104: InceptionV4/InceptionV4/Mixed_6e/Branch_2/Conv2d_0b_7x1/Conv2D	Convolution	CPU	7843	564591	572434
Iter 105: InceptionV4/InceptionV4/Mixed_6e/Branch_1/Conv2d_0c_7x1/Conv2D	Convolution	OpenCL	19988	557865	577853
Iter 106: InceptionV4/InceptionV4/Mixed_6e/Branch_2/Conv2d_0c_1x7/Conv2D	Convolution	CPU	11180	572579	583759
Iter 107: InceptionV4/InceptionV4/Mixed_6e/Branch_3/AvgPool_0a_3x3/AvgPool	Pooling	OpenCL	6315	577969	584284
Iter 108: InceptionV4/InceptionV4/Mixed_6e/Branch_3/Conv2d_0b_1x1/Conv2D	Convolution	OpenCL	5706	584399	590105
Iter 109: InceptionV4/InceptionV4/Mixed_6e/Branch_2/Conv2d_0d_7x1/Conv2D	Convolution	CPU	10855	583939	594794
Iter 110: InceptionV4/InceptionV4/Mixed_6e/Branch_2/Conv2d_0e_1x7/Conv2D	Convolution	CPU	11297	594934	606231
Iter 111: InceptionV4/InceptionV4/Mixed_6e/concat	Concat	CPU	967	606392	607359
Iter 112: InceptionV4/InceptionV4/Mixed_6f/Branch_1/Conv2d_0a_1x1/Conv2D	Convolution	OpenCL	9177	607531	616708
Iter 113: InceptionV4/InceptionV4/Mixed_6f/Branch_0/Conv2d_0a_1x1/Conv2D	Convolution	CPU	13059	607426	620485
Iter 114: InceptionV4/InceptionV4/Mixed_6f/Branch_2/Conv2d_0a_1x1/Conv2D	Convolution	CPU	6747	620583	627330
Iter 115: InceptionV4/InceptionV4/Mixed_6f/Branch_1/Conv2d_0b_1x7/Conv2D	Convolution	OpenCL	15789	616823	632612
Iter 116: InceptionV4/InceptionV4/Mixed_6f/Branch_2/Conv2d_0b_7x1/Conv2D	Convolution	CPU	7964	627474	635438
Iter 117: InceptionV4/InceptionV4/Mixed_6f/Branch_2/Conv2d_0c_1x7/Conv2D	Convolution	CPU	8816	635552	644368
Iter 118: InceptionV4/InceptionV4/Mixed_6f/Branch_1/Conv2d_0c_7x1/Conv2D	Convolution	OpenCL	20592	632735	653327
Iter 119: InceptionV4/InceptionV4/Mixed_6f/Branch_2/Conv2d_0d_7x1/Conv2D	Convolution	CPU	11705	644511	656216
Iter 120: InceptionV4/InceptionV4/Mixed_6f/Branch_3/AvgPool_0a_3x3/AvgPool	Pooling	OpenCL	7217	653455	660672
Iter 121: InceptionV4/InceptionV4/Mixed_6f/Branch_3/Conv2d_0b_1x1/Conv2D	Convolution	OpenCL	5628	660805	666433
Iter 122: InceptionV4/InceptionV4/Mixed_6f/Branch_2/Conv2d_0e_1x7/Conv2D	Convolution	CPU	14105	656397	670502
Iter 123: InceptionV4/InceptionV4/Mixed_6f/concat	Concat	OpenCL	2038	670675	672713
Iter 124: InceptionV4/InceptionV4/Mixed_6g/Branch_1/Conv2d_0a_1x1/Conv2D	Convolution	OpenCL	8366	672775	681141
Iter 125: InceptionV4/InceptionV4/Mixed_6g/Branch_0/Conv2d_0a_1x1/Conv2D	Convolution	CPU	21064	672866	693930
Iter 126: InceptionV4/InceptionV4/Mixed_6g/Branch_1/Conv2d_0b_1x7/Conv2D	Convolution	OpenCL	15521	681204	696725
Iter 127: InceptionV4/InceptionV4/Mixed_6g/Branch_2/Conv2d_0a_1x1/Conv2D	Convolution	CPU	10119	694080	704199
Iter 128: InceptionV4/InceptionV4/Mixed_6g/Branch_2/Conv2d_0b_7x1/Conv2D	Convolution	CPU	7873	704334	712207
Iter 129: InceptionV4/InceptionV4/Mixed_6g/Branch_1/Conv2d_0c_7x1/Conv2D	Convolution	OpenCL	20881	696795	717676
Iter 130: InceptionV4/InceptionV4/Mixed_6g/Branch_2/Conv2d_0c_1x7/Conv2D	Convolution	CPU	11170	712398	723568
Iter 131: InceptionV4/InceptionV4/Mixed_6g/Branch_3/AvgPool_0a_3x3/AvgPool	Pooling	OpenCL	6451	717808	724259
Iter 132: InceptionV4/InceptionV4/Mixed_6g/Branch_3/Conv2d_0b_1x1/Conv2D	Convolution	OpenCL	5846	724395	730241
Iter 133: InceptionV4/InceptionV4/Mixed_6g/Branch_2/Conv2d_0d_7x1/Conv2D	Convolution	CPU	10764	723776	734540
Iter 134: InceptionV4/InceptionV4/Mixed_6g/Branch_2/Conv2d_0e_1x7/Conv2D	Convolution	CPU	11423	734707	746130
Iter 135: InceptionV4/InceptionV4/Mixed_6g/concat	Concat	OpenCL	2387	746527	748914
Iter 136: InceptionV4/InceptionV4/Mixed_6h/Branch_1/Conv2d_0a_1x1/Conv2D	Convolution	OpenCL	8344	749037	757381
Iter 137: InceptionV4/InceptionV4/Mixed_6h/Branch_0/Conv2d_0a_1x1/Conv2D	Convolution	CPU	23014	749091	772105
Iter 138: InceptionV4/InceptionV4/Mixed_6h/Branch_1/Conv2d_0b_1x7/Conv2D	Convolution	OpenCL	17174	757490	774664
Iter 139: InceptionV4/InceptionV4/Mixed_6h/Branch_2/Conv2d_0a_1x1/Conv2D	Convolution	CPU	9081	772213	781294
Iter 140: InceptionV4/InceptionV4/Mixed_6h/Branch_2/Conv2d_0b_7x1/Conv2D	Convolution	CPU	7861	781441	789302
Iter 141: InceptionV4/InceptionV4/Mixed_6h/Branch_1/Conv2d_0c_7x1/Conv2D	Convolution	OpenCL	19982	774804	794786
Iter 142: InceptionV4/InceptionV4/Mixed_6h/Branch_2/Conv2d_0c_1x7/Conv2D	Convolution	CPU	11392	789445	800837
Iter 143: InceptionV4/InceptionV4/Mixed_6h/Branch_3/AvgPool_0a_3x3/AvgPool	Pooling	OpenCL	6398	794903	801301
Iter 144: InceptionV4/InceptionV4/Mixed_6h/Branch_3/Conv2d_0b_1x1/Conv2D	Convolution	OpenCL	5873	801440	807313
Iter 145: InceptionV4/InceptionV4/Mixed_6h/Branch_2/Conv2d_0d_7x1/Conv2D	Convolution	CPU	10713	800964	811677
Iter 146: InceptionV4/InceptionV4/Mixed_6h/Branch_2/Conv2d_0e_1x7/Conv2D	Convolution	CPU	11326	811948	823274
Iter 147: InceptionV4/InceptionV4/Mixed_6h/concat	Concat	OpenCL	2052	823489	825541
Iter 148: InceptionV4/InceptionV4/Mixed_7a/Branch_0/Conv2d_0a_1x1/Conv2D	Convolution	OpenCL	7692	825609	833301
Iter 149: InceptionV4/InceptionV4/Mixed_7a/Branch_0/Conv2d_1a_3x3/Conv2D	Convolution	OpenCL	4361	833354	837715
Iter 150: InceptionV4/InceptionV4/Mixed_7a/Branch_2/MaxPool_1a_3x3/MaxPool	Pooling	OpenCL	2466	837820	840286
Iter 151: InceptionV4/InceptionV4/Mixed_7a/Branch_1/Conv2d_0a_1x1/Conv2D	Convolution	CPU	18888	825703	844591
Iter 152: InceptionV4/InceptionV4/Mixed_7a/Branch_1/Conv2d_0b_1x7/Conv2D	Convolution	CPU	13245	844845	858090
Iter 153: InceptionV4/InceptionV4/Mixed_7a/Branch_1/Conv2d_0c_7x1/Conv2D	Convolution	CPU	17007	858259	875266
Iter 154: InceptionV4/InceptionV4/Mixed_7a/Branch_1/Conv2d_1a_3x3/Conv2D	Convolution	CPU	8347	875459	883806
Iter 155: InceptionV4/InceptionV4/Mixed_7a/concat	Concat	CPU	469	884033	884502
Iter 156: InceptionV4/InceptionV4/Mixed_7b/Branch_0/Conv2d_0a_1x1/Conv2D	Convolution	OpenCL	3925	884701	888626
Iter 157: InceptionV4/InceptionV4/Mixed_7b/Branch_2/Conv2d_0a_1x1/Conv2D	Convolution	CPU	4875	884570	889445
Iter 158: InceptionV4/InceptionV4/Mixed_7b/Branch_2/Conv2d_0b_3x1/Conv2D	Convolution	CPU	4832	889539	894371
Iter 159: InceptionV4/InceptionV4/Mixed_7b/Branch_1/Conv2d_0a_1x1/Conv2D	Convolution	OpenCL	5552	888941	894493
Iter 160: InceptionV4/InceptionV4/Mixed_7b/Branch_1/Conv2d_0b_1x3/Conv2D	Convolution	OpenCL	4025	894751	898776
Iter 161: InceptionV4/InceptionV4/Mixed_7b/Branch_2/Conv2d_0c_1x3/Conv2D	Convolution	CPU	6786	894492	901278
Iter 162: InceptionV4/InceptionV4/Mixed_7b/Branch_1/Conv2d_0c_3x1/Conv2D	Convolution	OpenCL	3526	898876	902402
Iter 163: InceptionV4/InceptionV4/Mixed_7b/Branch_1/concat	Concat	OpenCL	1339	902529	903868
Iter 164: InceptionV4/InceptionV4/Mixed_7b/Branch_2/Conv2d_0d_1x3/Conv2D	Convolution	CPU	4205	901395	905600
Iter 165: InceptionV4/InceptionV4/Mixed_7b/Branch_3/AvgPool_0a_3x3/AvgPool	Pooling	OpenCL	2954	903969	906923
Iter 166: InceptionV4/InceptionV4/Mixed_7b/Branch_2/Conv2d_0e_3x1/Conv2D	Convolution	CPU	3981	905767	909748
Iter 167: InceptionV4/InceptionV4/Mixed_7b/Branch_2/concat	Concat	CPU	84	909889	909973
Iter 168: InceptionV4/InceptionV4/Mixed_7b/Branch_3/Conv2d_0b_1x1/Conv2D	Convolution	OpenCL	3355	907048	910403
Iter 169: InceptionV4/InceptionV4/Mixed_7b/concat	Concat	CPU	813	910021	910834
Iter 170: InceptionV4/InceptionV4/Mixed_7c/Branch_0/Conv2d_0a_1x1/Conv2D	Convolution	CPU	3633	910890	914523
Iter 171: InceptionV4/InceptionV4/Mixed_7c/Branch_1/Conv2d_0a_1x1/Conv2D	Convolution	OpenCL	5533	910982	916515
Iter 172: InceptionV4/InceptionV4/Mixed_7c/Branch_2/Conv2d_0a_1x1/Conv2D	Convolution	CPU	5344	914658	920002
Iter 173: InceptionV4/InceptionV4/Mixed_7c/Branch_1/Conv2d_0b_1x3/Conv2D	Convolution	OpenCL	3922	916622	920544
Iter 174: InceptionV4/InceptionV4/Mixed_7c/Branch_1/Conv2d_0c_3x1/Conv2D	Convolution	OpenCL	3634	920656	924290
Iter 175: InceptionV4/InceptionV4/Mixed_7c/Branch_2/Conv2d_0b_3x1/Conv2D	Convolution	CPU	4980	920150	925130
Iter 176: InceptionV4/InceptionV4/Mixed_7c/Branch_1/concat	Concat	OpenCL	1399	924386	925785
Iter 177: InceptionV4/InceptionV4/Mixed_7c/Branch_3/AvgPool_0a_3x3/AvgPool	Pooling	OpenCL	2878	925878	928756
Iter 178: InceptionV4/InceptionV4/Mixed_7c/Branch_3/Conv2d_0b_1x1/Conv2D	Convolution	OpenCL	3278	928898	932176
Iter 179: InceptionV4/InceptionV4/Mixed_7c/Branch_2/Conv2d_0c_1x3/Conv2D	Convolution	CPU	7059	925211	932270
Iter 180: InceptionV4/InceptionV4/Mixed_7c/Branch_2/Conv2d_0d_1x3/Conv2D	Convolution	CPU	3392	932377	935769
Iter 181: InceptionV4/InceptionV4/Mixed_7c/Branch_2/Conv2d_0e_3x1/Conv2D	Convolution	CPU	3390	935901	939291
Iter 182: InceptionV4/InceptionV4/Mixed_7c/Branch_2/concat	Concat	CPU	176	939431	939607
Iter 183: InceptionV4/InceptionV4/Mixed_7c/concat	Concat	CPU	319	939675	939994
Iter 184: InceptionV4/InceptionV4/Mixed_7d/Branch_0/Conv2d_0a_1x1/Conv2D	Convolution	CPU	3473	940049	943522
Iter 185: InceptionV4/InceptionV4/Mixed_7d/Branch_1/Conv2d_0a_1x1/Conv2D	Convolution	OpenCL	5483	940172	945655
Iter 186: InceptionV4/InceptionV4/Mixed_7d/Branch_2/Conv2d_0a_1x1/Conv2D	Convolution	CPU	5153	943656	948809
Iter 187: InceptionV4/InceptionV4/Mixed_7d/Branch_1/Conv2d_0b_1x3/Conv2D	Convolution	OpenCL	4865	945761	950626
Iter 188: InceptionV4/InceptionV4/Mixed_7d/Branch_2/Conv2d_0b_3x1/Conv2D	Convolution	CPU	5154	948954	954108
Iter 189: InceptionV4/InceptionV4/Mixed_7d/Branch_1/Conv2d_0c_3x1/Conv2D	Convolution	OpenCL	3648	950744	954392
Iter 190: InceptionV4/InceptionV4/Mixed_7d/Branch_1/concat	Concat	OpenCL	1422	954475	955897
Iter 191: InceptionV4/InceptionV4/Mixed_7d/Branch_3/AvgPool_0a_3x3/AvgPool	Pooling	OpenCL	2923	956018	958941
Iter 192: InceptionV4/InceptionV4/Mixed_7d/Branch_2/Conv2d_0c_1x3/Conv2D	Convolution	CPU	7190	954211	961401
Iter 193: InceptionV4/InceptionV4/Mixed_7d/Branch_3/Conv2d_0b_1x1/Conv2D	Convolution	OpenCL	3245	959049	962294
Iter 194: InceptionV4/InceptionV4/Mixed_7d/Branch_2/Conv2d_0d_1x3/Conv2D	Convolution	CPU	3536	961494	965030
Iter 195: InceptionV4/InceptionV4/Mixed_7d/Branch_2/Conv2d_0e_3x1/Conv2D	Convolution	CPU	3390	965145	968535
Iter 196: InceptionV4/InceptionV4/Mixed_7d/Branch_2/concat	Concat	CPU	89	968671	968760
Iter 197: InceptionV4/InceptionV4/Mixed_7d/concat	Concat	CPU	357	968807	969164
Iter 198: InceptionV4/Logits/AvgPool_1a/AvgPool	Pooling	CPU	157	969214	969371
Iter 199: InceptionV4/Logits/PreLogitsFlatten/flatten/Shape	Shape	CPU	0	969442	969442
Iter 200: InceptionV4/Logits/PreLogitsFlatten/flatten/strided_slice	StridedSlice	CPU	2	969497	969499
Iter 201: InceptionV4/Logits/PreLogitsFlatten/flatten/Reshape/shape	Pack	CPU	0	969533	969533
Iter 202: InceptionV4/Logits/AvgPool_1a/AvgPool___tr4InceptionV4/Logits/PreLogitsFlatten/flatten/Reshape	ConvertTensor	CPU	5	969578	969583
Iter 203: InceptionV4/Logits/PreLogitsFlatten/flatten/Reshape	Reshape	CPU	3	969630	969633
Iter 204: InceptionV4/Logits/Logits/MatMul	MatMul	CPU	15361	969677	985038
Iter 205: InceptionV4/Logits/Logits/BiasAdd	BinaryOp	CPU	35	985154	985189
Iter 206: InceptionV4/Logits/Predictions	Softmax	CPU	19	985249	985268
Iter 0: InceptionV4/InceptionV4/Conv2d_1a_3x3/Conv2D	Convolution	CPU	4034	487	4521
Iter 1: InceptionV4/InceptionV4/Conv2d_2a_3x3/Conv2D	Convolution	CPU	11127	4928	16055
Iter 2: InceptionV4/InceptionV4/Conv2d_2b_3x3/Conv2D	Convolution	CPU	21325	16244	37569
Iter 3: InceptionV4/InceptionV4/Mixed_3a/Branch_0/MaxPool_0a_3x3/MaxPool	Pooling	CPU	1673	37784	39457
Iter 4: InceptionV4/InceptionV4/Mixed_3a/Branch_1/Conv2d_0a_3x3/Conv2D	Convolution	CPU	27469	39595	67064
Iter 5: InceptionV4/InceptionV4/Mixed_3a/concat	Concat	CPU	1890	67224	69114
Iter 6: InceptionV4/InceptionV4/Mixed_4a/Branch_1/Conv2d_0a_1x1/Conv2D	Convolution	CPU	4664	69173	73837
Iter 7: InceptionV4/InceptionV4/Mixed_4a/Branch_0/Conv2d_0a_1x1/Conv2D	Convolution	OpenCL	13762	69352	83114
Iter 8: InceptionV4/InceptionV4/Mixed_4a/Branch_1/Conv2d_0b_1x7/Conv2D	Convolution	CPU	14597	73963	88560
Iter 9: InceptionV4/InceptionV4/Mixed_4a/Branch_1/Conv2d_0c_7x1/Conv2D	Convolution	CPU	15816	88752	104568
Iter 10: InceptionV4/InceptionV4/Mixed_4a/Branch_0/Conv2d_1a_3x3/Conv2D	Convolution	OpenCL	29343	83211	112554
Iter 11: InceptionV4/InceptionV4/Mixed_4a/Branch_1/Conv2d_1a_3x3/Conv2D	Convolution	CPU	15237	104890	120127
Iter 12: InceptionV4/InceptionV4/Mixed_4a/concat	Concat	CPU	2943	120298	123241
Iter 13: InceptionV4/InceptionV4/Mixed_5a/Branch_0/Conv2d_1a_3x3/Conv2D	Convolution	CPU	37344	123294	160638
Iter 14: InceptionV4/InceptionV4/Mixed_5a/Branch_1/MaxPool_1a_3x3/MaxPool	Pooling	CPU	1394	160811	162205
Iter 15: InceptionV4/InceptionV4/Mixed_5a/concat	Concat	CPU	1123	162307	163430
Iter 16: InceptionV4/InceptionV4/Mixed_5b/Branch_0/Conv2d_0a_1x1/Conv2D	Convolution	CPU	3879	163496	167375
Iter 17: InceptionV4/InceptionV4/Mixed_5b/Branch_1/Conv2d_0a_1x1/Conv2D	Convolution	OpenCL	5865	163589	169454
Iter 18: InceptionV4/InceptionV4/Mixed_5b/Branch_2/Conv2d_0a_1x1/Conv2D	Convolution	CPU	2710	167542	170252
Iter 19: InceptionV4/InceptionV4/Mixed_5b/Branch_2/Conv2d_0b_3x3/Conv2D	Convolution	CPU	5353	170357	175710
Iter 20: InceptionV4/InceptionV4/Mixed_5b/Branch_1/Conv2d_0b_3x3/Conv2D	Convolution	OpenCL	8815	169550	178365
Iter 21: InceptionV4/InceptionV4/Mixed_5b/Branch_2/Conv2d_0c_3x3/Conv2D	Convolution	CPU	6594	175905	182499
Iter 22: InceptionV4/InceptionV4/Mixed_5b/Branch_3/AvgPool_0a_3x3/AvgPool	Pooling	CPU	1911	182774	184685
Iter 23: InceptionV4/InceptionV4/Mixed_5b/Branch_3/Conv2d_0b_1x1/Conv2D	Convolution	CPU	3835	184795	188630
Iter 24: InceptionV4/InceptionV4/Mixed_5b/concat	Concat	CPU	1405	188759	190164
Iter 25: InceptionV4/InceptionV4/Mixed_5c/Branch_0/Conv2d_0a_1x1/Conv2D	Convolution	CPU	4032	190228	194260
Iter 26: InceptionV4/InceptionV4/Mixed_5c/Branch_3/AvgPool_0a_3x3/AvgPool	Pooling	OpenCL	6110	190329	196439
Iter 27: InceptionV4/InceptionV4/Mixed_5c/Branch_1/Conv2d_0a_1x1/Conv2D	Convolution	CPU	2964	194437	197401
Iter 28: InceptionV4/InceptionV4/Mixed_5c/Branch_1/Conv2d_0b_3x3/Conv2D	Convolution	CPU	4043	197492	201535
Iter 29: InceptionV4/InceptionV4/Mixed_5c/Branch_3/Conv2d_0b_1x1/Conv2D	Convolution	OpenCL	6268	196606	202874
Iter 30: InceptionV4/InceptionV4/Mixed_5c/Branch_2/Conv2d_0a_1x1/Conv2D	Convolution	CPU	2833	201676	204509
Iter 31: InceptionV4/InceptionV4/Mixed_5c/Branch_2/Conv2d_0b_3x3/Conv2D	Convolution	CPU	3733	204656	208389
Iter 32: InceptionV4/InceptionV4/Mixed_5c/Branch_2/Conv2d_0c_3x3/Conv2D	Convolution	CPU	5570	208533	214103
Iter 33: InceptionV4/InceptionV4/Mixed_5c/concat	Concat	CPU	1424	214370	215794
Iter 34: InceptionV4/InceptionV4/Mixed_5d/Branch_0/Conv2d_0a_1x1/Conv2D	Convolution	CPU	4024	215852	219876
Iter 35: InceptionV4/InceptionV4/Mixed_5d/Branch_3/AvgPool_0a_3x3/AvgPool	Pooling	OpenCL	6023	216008	222031
Iter 36: InceptionV4/InceptionV4/Mixed_5d/Branch_1/Conv2d_0a_1x1/Conv2D	Convolution	CPU	2861	220044	222905
Iter 37: InceptionV4/InceptionV4/Mixed_5d/Branch_1/Conv2d_0b_3x3/Conv2D	Convolution	CPU	3964	223008	226972
Iter 38: InceptionV4/InceptionV4/Mixed_5d/Branch_3/Conv2d_0b_1x1/Conv2D	Convolution	OpenCL	7085	222135	229220
Iter 39: InceptionV4/InceptionV4/Mixed_5d/Branch_2/Conv2d_0a_1x1/Conv2D	Convolution	CPU	2787	227100	229887
Iter 40: InceptionV4/InceptionV4/Mixed_5d/Branch_2/Conv2d_0b_3x3/Conv2D	Convolution	CPU	3791	229980	233771
Iter 41: InceptionV4/InceptionV4/Mixed_5d/Branch_2/Conv2d_0c_3x3/Conv2D	Convolution	CPU	5575	234063	239638
Iter 42: InceptionV4/InceptionV4/Mixed_5d/concat	Concat	CPU	1374	239834	241208
Iter 43: InceptionV4/InceptionV4/Mixed_5e/Branch_0/Conv2d_0a_1x1/Conv2D	Convolution	CPU	4082	241279	245361
Iter 44: InceptionV4/InceptionV4/Mixed_5e/Branch_3/AvgPool_0a_3x3/AvgPool	Pooling	OpenCL	6045	241414	247459
Iter 45: InceptionV4/InceptionV4/Mixed_5e/Branch_1/Conv2d_0a_1x1/Conv2D	Convolution	CPU	2867	245531	248398
Iter 46: InceptionV4/InceptionV4/Mixed_5e/Branch_1/Conv2d_0b_3x3/Conv2D	Convolution	CPU	3917	248497	252414
Iter 47: InceptionV4/InceptionV4/Mixed_5e/Branch_3/Conv2d_0b_1x1/Conv2D	Convolution	OpenCL	6223	247557	253780
Iter 48: InceptionV4/InceptionV4/Mixed_5e/Branch_2/Conv2d_0a_1x1/Conv2D	Convolution	CPU	2866	252550	255416
Iter 49: InceptionV4/InceptionV4/Mixed_5e/Branch_2/Conv2d_0b_3x3/Conv2D	Convolution	CPU	3718	255516	259234
Iter 50: InceptionV4/InceptionV4/Mixed_5e/Branch_2/Conv2d_0c_3x3/Conv2D	Convolution	CPU	5558	259499	265057
Iter 51: InceptionV4/InceptionV4/Mixed_5e/concat	Concat	CPU	1331	265223	266554
Iter 52: InceptionV4/InceptionV4/Mixed_6a/Branch_1/Conv2d_0a_1x1/Conv2D	Convolution	CPU	7541	266612	274153
Iter 53: InceptionV4/InceptionV4/Mixed_6a/Branch_1/Conv2d_0b_3x3/Conv2D	Convolution	CPU	27618	274301	301919
Iter 54: InceptionV4/InceptionV4/Mixed_6a/Branch_1/Conv2d_1a_3x3/Conv2D	Convolution	CPU	17153	302073	319226
Iter 55: InceptionV4/InceptionV4/Mixed_6a/Branch_2/MaxPool_1a_3x3/MaxPool	Pooling	CPU	762	319354	320116
Iter 56: InceptionV4/InceptionV4/Mixed_6a/Branch_0/Conv2d_1a_3x3/Conv2D	Convolution	OpenCL	73094	266765	339859
Iter 57: InceptionV4/InceptionV4/Mixed_6a/concat	Concat	CPU	20629	320239	340868
Iter 58: InceptionV4/InceptionV4/Mixed_6b/Branch_1/Conv2d_0a_1x1/Conv2D	Convolution	OpenCL	9369	341040	350409
Iter 59: InceptionV4/InceptionV4/Mixed_6b/Branch_0/Conv2d_0a_1x1/Conv2D	Convolution	CPU	13113	340920	354033
Iter 60: InceptionV4/InceptionV4/Mixed_6b/Branch_2/Conv2d_0a_1x1/Conv2D	Convolution	CPU	6785	354121	360906
Iter 61: InceptionV4/InceptionV4/Mixed_6b/Branch_1/Conv2d_0b_1x7/Conv2D	Convolution	OpenCL	15722	350538	366260
Iter 62: InceptionV4/InceptionV4/Mixed_6b/Branch_2/Conv2d_0b_7x1/Conv2D	Convolution	CPU	8055	361047	369102
Iter 63: InceptionV4/InceptionV4/Mixed_6b/Branch_2/Conv2d_0c_1x7/Conv2D	Convolution	CPU	8881	369219	378100
Iter 64: InceptionV4/InceptionV4/Mixed_6b/Branch_1/Conv2d_0c_7x1/Conv2D	Convolution	OpenCL	19483	366382	385865
Iter 65: InceptionV4/InceptionV4/Mixed_6b/Branch_2/Conv2d_0d_7x1/Conv2D	Convolution	CPU	11846	378252	390098
Iter 66: InceptionV4/InceptionV4/Mixed_6b/Branch_3/AvgPool_0a_3x3/AvgPool	Pooling	OpenCL	7565	386063	393628
Iter 67: InceptionV4/InceptionV4/Mixed_6b/Branch_3/Conv2d_0b_1x1/Conv2D	Convolution	OpenCL	5660	393747	399407
Iter 68: InceptionV4/InceptionV4/Mixed_6b/Branch_2/Conv2d_0e_1x7/Conv2D	Convolution	CPU	13534	390307	403841
Iter 69: InceptionV4/InceptionV4/Mixed_6b/concat	Concat	CPU	1045	404001	405046
Iter 70: InceptionV4/InceptionV4/Mixed_6c/Branch_1/Conv2d_0a_1x1/Conv2D	Convolution	OpenCL	9178	405333	414511
Iter 71: InceptionV4/InceptionV4/Mixed_6c/Branch_0/Conv2d_0a_1x1/Conv2D	Convolution	CPU	12992	405104	418096
Iter 72: InceptionV4/InceptionV4/Mixed_6c/Branch_2/Conv2d_0a_1x1/Conv2D	Convolution	CPU	6717	418190	424907
Iter 73: InceptionV4/InceptionV4/Mixed_6c/Branch_1/Conv2d_0b_1x7/Conv2D	Convolution	OpenCL	15767	414674	430441
Iter 74: InceptionV4/InceptionV4/Mixed_6c/Branch_2/Conv2d_0b_7x1/Conv2D	Convolution	CPU	7975	425037	433012
Iter 75: InceptionV4/InceptionV4/Mixed_6c/Branch_2/Conv2d_0c_1x7/Conv2D	Convolution	CPU	8832	433124	441956
Iter 76: InceptionV4/InceptionV4/Mixed_6c/Branch_1/Conv2d_0c_7x1/Conv2D	Convolution	OpenCL	19546	430553	450099
Iter 77: InceptionV4/InceptionV4/Mixed_6c/Branch_2/Conv2d_0d_7x1/Conv2D	Convolution	CPU	11587	442095	453682
Iter 78: InceptionV4/InceptionV4/Mixed_6c/Branch_3/AvgPool_0a_3x3/AvgPool	Pooling	OpenCL	7408	450233	457641
Iter 79: InceptionV4/InceptionV4/Mixed_6c/Branch_3/Conv2d_0b_1x1/Conv2D	Convolution	OpenCL	5603	457781	463384
Iter 80: InceptionV4/InceptionV4/Mixed_6c/Branch_2/Conv2d_0e_1x7/Conv2D	Convolution	CPU	13808	453866	467674
Iter 81: InceptionV4/InceptionV4/Mixed_6c/concat	Concat	CPU	948	467825	468773
Iter 82: InceptionV4/InceptionV4/Mixed_6d/Branch_1/Conv2d_0a_1x1/Conv2D	Convolution	OpenCL	9283	468915	478198
Iter 83: InceptionV4/InceptionV4/Mixed_6d/Branch_0/Conv2d_0a_1x1/Conv2D	Convolution	CPU	13067	468833	481900
Iter 84: InceptionV4/InceptionV4/Mixed_6d/Branch_2/Conv2d_0a_1x1/Conv2D	Convolution	CPU	6751	481997	488748
Iter 85: InceptionV4/InceptionV4/Mixed_6d/Branch_1/Conv2d_0b_1x7/Conv2D	Convolution	OpenCL	15811	478331	494142
Iter 86: InceptionV4/InceptionV4/Mixed_6d/Branch_2/Conv2d_0b_7x1/Conv2D	Convolution	CPU	8135	488879	497014
Iter 87: InceptionV4/InceptionV4/Mixed_6d/Branch_2/Conv2d_0c_1x7/Conv2D	Convolution	CPU	8813	497121	505934
Iter 88: InceptionV4/InceptionV4/Mixed_6d/Branch_1/Conv2d_0c_7x1/Conv2D	Convolution	OpenCL	19608	494300	513908
Iter 89: InceptionV4/InceptionV4/Mixed_6d/Branch_2/Conv2d_0d_7x1/Conv2D	Convolution	CPU	11974	506074	518048
Iter 90: InceptionV4/InceptionV4/Mixed_6d/Branch_3/AvgPool_0a_3x3/AvgPool	Pooling	OpenCL	7353	514041	521394
Iter 91: InceptionV4/InceptionV4/Mixed_6d/Branch_3/Conv2d_0b_1x1/Conv2D	Convolution	OpenCL	5634	521508	527142
Iter 92: InceptionV4/InceptionV4/Mixed_6d/Branch_2/Conv2d_0e_1x7/Conv2D	Convolution	CPU	13398	518256	531654
Iter 93: InceptionV4/Logits/PreLogitsFlatten/flatten/strided_slice/stack	Const	CPU	1	531865	531866
Iter 94: InceptionV4/Logits/PreLogitsFlatten/flatten/strided_slice/stack_1	Const	CPU	1	531986	531987
Iter 95: InceptionV4/Logits/PreLogitsFlatten/flatten/strided_slice/stack_2	Const	CPU	0	532041	532041
Iter 96: InceptionV4/Logits/PreLogitsFlatten/flatten/Reshape/shape/1	Const	CPU	1	532100	532101
Iter 97: InceptionV4/Logits/Logits/weights	Const	CPU	0	532160	532160
Iter 98: InceptionV4/Logits/Logits/biases	Const	CPU	0	532224	532224
Iter 99: InceptionV4/InceptionV4/Mixed_6d/concat	Concat	OpenCL	2102	531936	534038
Iter 100: InceptionV4/InceptionV4/Mixed_6e/Branch_1/Conv2d_0a_1x1/Conv2D	Convolution	OpenCL	8385	534099	542484
Iter 101: InceptionV4/InceptionV4/Mixed_6e/Branch_0/Conv2d_0a_1x1/Conv2D	Convolution	CPU	21233	534185	555418
Iter 102: InceptionV4/InceptionV4/Mixed_6e/Branch_1/Conv2d_0b_1x7/Conv2D	Convolution	OpenCL	15488	542545	558033
Iter 103: InceptionV4/InceptionV4/Mixed_6e/Branch_2/Conv2d_0a_1x1/Conv2D	Convolution	CPU	9891	555560	565451
Iter 104: InceptionV4/InceptionV4/Mixed_6e/Branch_2/Conv2d_0b_7x1/Conv2D	Convolution	CPU	7824	565576	573400
Iter 105: InceptionV4/InceptionV4/Mixed_6e/Branch_1/Conv2d_0c_7x1/Conv2D	Convolution	OpenCL	20621	558100	578721
Iter 106: InceptionV4/InceptionV4/Mixed_6e/Branch_2/Conv2d_0c_1x7/Conv2D	Convolution	CPU	11387	573546	584933
Iter 107: InceptionV4/InceptionV4/Mixed_6e/Branch_3/AvgPool_0a_3x3/AvgPool	Pooling	OpenCL	6230	578856	585086
Iter 108: InceptionV4/InceptionV4/Mixed_6e/Branch_3/Conv2d_0b_1x1/Conv2D	Convolution	OpenCL	5748	585169	590917
Iter 109: InceptionV4/InceptionV4/Mixed_6e/Branch_2/Conv2d_0d_7x1/Conv2D	Convolution	CPU	10730	585048	595778
Iter 110: InceptionV4/InceptionV4/Mixed_6e/Branch_2/Conv2d_0e_1x7/Conv2D	Convolution	CPU	11330	595997	607327
Iter 111: InceptionV4/InceptionV4/Mixed_6e/concat	Concat	CPU	955	607495	608450
Iter 112: InceptionV4/InceptionV4/Mixed_6f/Branch_1/Conv2d_0a_1x1/Conv2D	Convolution	OpenCL	9301	608594	617895
Iter 113: InceptionV4/InceptionV4/Mixed_6f/Branch_0/Conv2d_0a_1x1/Conv2D	Convolution	CPU	13109	608540	621649
Iter 114: InceptionV4/InceptionV4/Mixed_6f/Branch_2/Conv2d_0a_1x1/Conv2D	Convolution	CPU	6731	621746	628477
Iter 115: InceptionV4/InceptionV4/Mixed_6f/Branch_1/Conv2d_0b_1x7/Conv2D	Convolution	OpenCL	15841	618010	633851
Iter 116: InceptionV4/InceptionV4/Mixed_6f/Branch_2/Conv2d_0b_7x1/Conv2D	Convolution	CPU	8043	628620	636663
Iter 117: InceptionV4/InceptionV4/Mixed_6f/Branch_2/Conv2d_0c_1x7/Conv2D	Convolution	CPU	8926	636774	645700
Iter 118: InceptionV4/InceptionV4/Mixed_6f/Branch_1/Conv2d_0c_7x1/Conv2D	Convolution	OpenCL	20498	633975	654473
Iter 119: InceptionV4/InceptionV4/Mixed_6f/Branch_2/Conv2d_0d_7x1/Conv2D	Convolution	CPU	11591	645825	657416
Iter 120: InceptionV4/InceptionV4/Mixed_6f/Branch_3/AvgPool_0a_3x3/AvgPool	Pooling	OpenCL	7236	654635	661871
Iter 121: InceptionV4/InceptionV4/Mixed_6f/Branch_3/Conv2d_0b_1x1/Conv2D	Convolution	OpenCL	5612	661975	667587
Iter 122: InceptionV4/InceptionV4/Mixed_6f/Branch_2/Conv2d_0e_1x7/Conv2D	Convolution	CPU	14007	657653	671660
Iter 123: InceptionV4/InceptionV4/Mixed_6f/concat	Concat	OpenCL	2072	671815	673887
Iter 124: InceptionV4/InceptionV4/Mixed_6g/Branch_1/Conv2d_0a_1x1/Conv2D	Convolution	OpenCL	7661	673949	681610
Iter 125: InceptionV4/InceptionV4/Mixed_6g/Branch_0/Conv2d_0a_1x1/Conv2D	Convolution	CPU	21528	674046	695574
Iter 126: InceptionV4/InceptionV4/Mixed_6g/Branch_1/Conv2d_0b_1x7/Conv2D	Convolution	OpenCL	16403	681664	698067
Iter 127: InceptionV4/InceptionV4/Mixed_6g/Branch_2/Conv2d_0a_1x1/Conv2D	Convolution	CPU	9013	695729	704742
Iter 128: InceptionV4/InceptionV4/Mixed_6g/Branch_2/Conv2d_0b_7x1/Conv2D	Convolution	CPU	7834	704869	712703
Iter 129: InceptionV4/InceptionV4/Mixed_6g/Branch_1/Conv2d_0c_7x1/Conv2D	Convolution	OpenCL	20030	698214	718244
Iter 130: InceptionV4/InceptionV4/Mixed_6g/Branch_2/Conv2d_0c_1x7/Conv2D	Convolution	CPU	11214	712927	724141
Iter 131: InceptionV4/InceptionV4/Mixed_6g/Branch_3/AvgPool_0a_3x3/AvgPool	Pooling	OpenCL	6292	718369	724661
Iter 132: InceptionV4/InceptionV4/Mixed_6g/Branch_3/Conv2d_0b_1x1/Conv2D	Convolution	OpenCL	5675	724757	730432
Iter 133: InceptionV4/InceptionV4/Mixed_6g/Branch_2/Conv2d_0d_7x1/Conv2D	Convolution	CPU	10747	724326	735073
Iter 134: InceptionV4/InceptionV4/Mixed_6g/Branch_2/Conv2d_0e_1x7/Conv2D	Convolution	CPU	11375	735210	746585
Iter 135: InceptionV4/InceptionV4/Mixed_6g/concat	Concat	OpenCL	2096	746856	748952
Iter 136: InceptionV4/InceptionV4/Mixed_6h/Branch_1/Conv2d_0a_1x1/Conv2D	Convolution	OpenCL	8113	749012	757125
Iter 137: InceptionV4/InceptionV4/Mixed_6h/Branch_0/Conv2d_0a_1x1/Conv2D	Convolution	CPU	21904	749105	771009
Iter 138: InceptionV4/InceptionV4/Mixed_6h/Branch_1/Conv2d_0b_1x7/Conv2D	Convolution	OpenCL	16396	757209	773605
Iter 139: InceptionV4/InceptionV4/Mixed_6h/Branch_2/Conv2d_0a_1x1/Conv2D	Convolution	CPU	9950	771160	781110
Iter 140: InceptionV4/InceptionV4/Mixed_6h/Branch_2/Conv2d_0b_7x1/Conv2D	Convolution	CPU	7897	781255	789152
Iter 141: InceptionV4/InceptionV4/Mixed_6h/Branch_1/Conv2d_0c_7x1/Conv2D	Convolution	OpenCL	20702	773690	794392
Iter 142: InceptionV4/InceptionV4/Mixed_6h/Branch_3/AvgPool_0a_3x3/AvgPool	Pooling	OpenCL	6242	794514	800756
Iter 143: InceptionV4/InceptionV4/Mixed_6h/Branch_2/Conv2d_0c_1x7/Conv2D	Convolution	CPU	11490	789293	800783
Iter 144: InceptionV4/InceptionV4/Mixed_6h/Branch_3/Conv2d_0b_1x1/Conv2D	Convolution	OpenCL	5707	800882	806589
Iter 145: InceptionV4/InceptionV4/Mixed_6h/Branch_2/Conv2d_0d_7x1/Conv2D	Convolution	CPU	10623	800984	811607
Iter 146: InceptionV4/InceptionV4/Mixed_6h/Branch_2/Conv2d_0e_1x7/Conv2D	Convolution	CPU	11333	811780	823113
Iter 147: InceptionV4/InceptionV4/Mixed_6h/concat	Concat	OpenCL	2110	823345	825455
Iter 148: InceptionV4/InceptionV4/Mixed_7a/Branch_0/Conv2d_0a_1x1/Conv2D	Convolution	OpenCL	7565	825515	833080
Iter 149: InceptionV4/InceptionV4/Mixed_7a/Branch_0/Conv2d_1a_3x3/Conv2D	Convolution	OpenCL	4197	833130	837327
Iter 150: InceptionV4/InceptionV4/Mixed_7a/Branch_2/MaxPool_1a_3x3/MaxPool	Pooling	OpenCL	2221	837434	839655
Iter 151: InceptionV4/InceptionV4/Mixed_7a/Branch_1/Conv2d_0a_1x1/Conv2D	Convolution	CPU	18663	825611	844274
Iter 152: InceptionV4/InceptionV4/Mixed_7a/Branch_1/Conv2d_0b_1x7/Conv2D	Convolution	CPU	13252	844425	857677
Iter 153: InceptionV4/InceptionV4/Mixed_7a/Branch_1/Conv2d_0c_7x1/Conv2D	Convolution	CPU	17062	857832	874894
Iter 154: InceptionV4/InceptionV4/Mixed_7a/Branch_1/Conv2d_1a_3x3/Conv2D	Convolution	CPU	8187	875075	883262
Iter 155: InceptionV4/InceptionV4/Mixed_7a/concat	Concat	CPU	450	883499	883949
Iter 156: InceptionV4/InceptionV4/Mixed_7b/Branch_0/Conv2d_0a_1x1/Conv2D	Convolution	OpenCL	3958	884162	888120
Iter 157: InceptionV4/InceptionV4/Mixed_7b/Branch_2/Conv2d_0a_1x1/Conv2D	Convolution	CPU	4879	884007	888886
Iter 158: InceptionV4/InceptionV4/Mixed_7b/Branch_1/Conv2d_0a_1x1/Conv2D	Convolution	OpenCL	5230	888233	893463
Iter 159: InceptionV4/InceptionV4/Mixed_7b/Branch_2/Conv2d_0b_3x1/Conv2D	Convolution	CPU	4765	888990	893755
Iter 160: InceptionV4/InceptionV4/Mixed_7b/Branch_1/Conv2d_0b_1x3/Conv2D	Convolution	OpenCL	3869	893573	897442
Iter 161: InceptionV4/InceptionV4/Mixed_7b/Branch_2/Conv2d_0c_1x3/Conv2D	Convolution	CPU	6888	893836	900724
Iter 162: InceptionV4/InceptionV4/Mixed_7b/Branch_1/Conv2d_0c_3x1/Conv2D	Convolution	OpenCL	3602	897558	901160
Iter 163: InceptionV4/InceptionV4/Mixed_7b/Branch_1/concat	Concat	OpenCL	1448	901263	902711
Iter 164: InceptionV4/InceptionV4/Mixed_7b/Branch_2/Conv2d_0d_1x3/Conv2D	Convolution	CPU	4233	900833	905066
Iter 165: InceptionV4/InceptionV4/Mixed_7b/Branch_3/AvgPool_0a_3x3/AvgPool	Pooling	OpenCL	2919	902814	905733
Iter 166: InceptionV4/InceptionV4/Mixed_7b/Branch_2/Conv2d_0e_3x1/Conv2D	Convolution	CPU	3813	905213	909026
Iter 167: InceptionV4/InceptionV4/Mixed_7b/Branch_2/concat	Concat	CPU	77	909140	909217
Iter 168: InceptionV4/InceptionV4/Mixed_7b/Branch_3/Conv2d_0b_1x1/Conv2D	Convolution	OpenCL	3549	905893	909442
Iter 169: InceptionV4/InceptionV4/Mixed_7b/concat	Concat	CPU	608	909264	909872
Iter 170: InceptionV4/InceptionV4/Mixed_7c/Branch_0/Conv2d_0a_1x1/Conv2D	Convolution	CPU	3688	909934	913622
Iter 171: InceptionV4/InceptionV4/Mixed_7c/Branch_1/Conv2d_0a_1x1/Conv2D	Convolution	OpenCL	5803	910002	915805
Iter 172: InceptionV4/InceptionV4/Mixed_7c/Branch_2/Conv2d_0a_1x1/Conv2D	Convolution	CPU	5822	913758	919580
Iter 173: InceptionV4/InceptionV4/Mixed_7c/Branch_1/Conv2d_0b_1x3/Conv2D	Convolution	OpenCL	3980	915925	919905
Iter 174: InceptionV4/InceptionV4/Mixed_7c/Branch_1/Conv2d_0c_3x1/Conv2D	Convolution	OpenCL	3649	919990	923639
Iter 175: InceptionV4/InceptionV4/Mixed_7c/Branch_2/Conv2d_0b_3x1/Conv2D	Convolution	CPU	5100	919708	924808
Iter 176: InceptionV4/InceptionV4/Mixed_7c/Branch_1/concat	Concat	OpenCL	1278	923754	925032
Iter 177: InceptionV4/InceptionV4/Mixed_7c/Branch_3/AvgPool_0a_3x3/AvgPool	Pooling	OpenCL	3168	925091	928259
Iter 178: InceptionV4/InceptionV4/Mixed_7c/Branch_3/Conv2d_0b_1x1/Conv2D	Convolution	OpenCL	3388	928379	931767
Iter 179: InceptionV4/InceptionV4/Mixed_7c/Branch_2/Conv2d_0c_1x3/Conv2D	Convolution	CPU	7044	924887	931931
Iter 180: InceptionV4/InceptionV4/Mixed_7c/Branch_2/Conv2d_0d_1x3/Conv2D	Convolution	CPU	3539	932156	935695
Iter 181: InceptionV4/InceptionV4/Mixed_7c/Branch_2/Conv2d_0e_3x1/Conv2D	Convolution	CPU	3509	935840	939349
Iter 182: InceptionV4/InceptionV4/Mixed_7c/Branch_2/concat	Concat	CPU	85	939505	939590
Iter 183: InceptionV4/InceptionV4/Mixed_7c/concat	Concat	CPU	369	939654	940023
Iter 184: InceptionV4/InceptionV4/Mixed_7d/Branch_0/Conv2d_0a_1x1/Conv2D	Convolution	CPU	3686	940070	943756
Iter 185: InceptionV4/InceptionV4/Mixed_7d/Branch_1/Conv2d_0a_1x1/Conv2D	Convolution	OpenCL	5635	940379	946014
Iter 186: InceptionV4/InceptionV4/Mixed_7d/Branch_2/Conv2d_0a_1x1/Conv2D	Convolution	CPU	5605	943885	949490
Iter 187: InceptionV4/InceptionV4/Mixed_7d/Branch_1/Conv2d_0b_1x3/Conv2D	Convolution	OpenCL	4983	946119	951102
Iter 188: InceptionV4/InceptionV4/Mixed_7d/Branch_2/Conv2d_0b_3x1/Conv2D	Convolution	CPU	5148	949645	954793
Iter 189: InceptionV4/InceptionV4/Mixed_7d/Branch_1/Conv2d_0c_3x1/Conv2D	Convolution	OpenCL	3768	951203	954971
Iter 190: InceptionV4/InceptionV4/Mixed_7d/Branch_1/concat	Concat	OpenCL	1402	955033	956435
Iter 191: InceptionV4/InceptionV4/Mixed_7d/Branch_3/AvgPool_0a_3x3/AvgPool	Pooling	OpenCL	2933	956536	959469
Iter 192: InceptionV4/InceptionV4/Mixed_7d/Branch_2/Conv2d_0c_1x3/Conv2D	Convolution	CPU	7132	954896	962028
Iter 193: InceptionV4/InceptionV4/Mixed_7d/Branch_3/Conv2d_0b_1x1/Conv2D	Convolution	OpenCL	3489	959579	963068
Iter 194: InceptionV4/InceptionV4/Mixed_7d/Branch_2/Conv2d_0d_1x3/Conv2D	Convolution	CPU	3605	962128	965733
Iter 195: InceptionV4/InceptionV4/Mixed_7d/Branch_2/Conv2d_0e_3x1/Conv2D	Convolution	CPU	3408	965837	969245
Iter 196: InceptionV4/InceptionV4/Mixed_7d/Branch_2/concat	Concat	CPU	69	969375	969444
Iter 197: InceptionV4/InceptionV4/Mixed_7d/concat	Concat	CPU	345	969486	969831
Iter 198: InceptionV4/Logits/AvgPool_1a/AvgPool	Pooling	CPU	163	969906	970069
Iter 199: InceptionV4/Logits/PreLogitsFlatten/flatten/Shape	Shape	CPU	2	970138	970140
Iter 200: InceptionV4/Logits/PreLogitsFlatten/flatten/strided_slice	StridedSlice	CPU	1	970177	970178
Iter 201: InceptionV4/Logits/PreLogitsFlatten/flatten/Reshape/shape	Pack	CPU	0	970212	970212
Iter 202: InceptionV4/Logits/AvgPool_1a/AvgPool___tr4InceptionV4/Logits/PreLogitsFlatten/flatten/Reshape	ConvertTensor	CPU	6	970257	970263
Iter 203: InceptionV4/Logits/PreLogitsFlatten/flatten/Reshape	Reshape	CPU	6	970313	970319
Iter 204: InceptionV4/Logits/Logits/MatMul	MatMul	CPU	15604	970363	985967
Iter 205: InceptionV4/Logits/Logits/BiasAdd	BinaryOp	CPU	37	986080	986117
Iter 206: InceptionV4/Logits/Predictions	Softmax	CPU	20	986156	986176
Iter 0: InceptionV4/InceptionV4/Conv2d_1a_3x3/Conv2D	Convolution	CPU	4144	342	4486
Iter 1: InceptionV4/InceptionV4/Conv2d_2a_3x3/Conv2D	Convolution	CPU	11287	4729	16016
Iter 2: InceptionV4/InceptionV4/Conv2d_2b_3x3/Conv2D	Convolution	CPU	21666	16195	37861
Iter 3: InceptionV4/InceptionV4/Mixed_3a/Branch_0/MaxPool_0a_3x3/MaxPool	Pooling	CPU	1706	38001	39707
Iter 4: InceptionV4/InceptionV4/Mixed_3a/Branch_1/Conv2d_0a_3x3/Conv2D	Convolution	CPU	27653	39850	67503
Iter 5: InceptionV4/InceptionV4/Mixed_3a/concat	Concat	CPU	1970	67664	69634
Iter 6: InceptionV4/InceptionV4/Mixed_4a/Branch_1/Conv2d_0a_1x1/Conv2D	Convolution	CPU	4666	69697	74363
Iter 7: InceptionV4/InceptionV4/Mixed_4a/Branch_0/Conv2d_0a_1x1/Conv2D	Convolution	OpenCL	13728	69874	83602
Iter 8: InceptionV4/InceptionV4/Mixed_4a/Branch_1/Conv2d_0b_1x7/Conv2D	Convolution	CPU	14578	74495	89073
Iter 9: InceptionV4/InceptionV4/Mixed_4a/Branch_1/Conv2d_0c_7x1/Conv2D	Convolution	CPU	15840	89253	105093
Iter 10: InceptionV4/InceptionV4/Mixed_4a/Branch_0/Conv2d_1a_3x3/Conv2D	Convolution	OpenCL	29107	83726	112833
Iter 11: InceptionV4/InceptionV4/Mixed_4a/Branch_1/Conv2d_1a_3x3/Conv2D	Convolution	CPU	15488	105370	120858
Iter 12: InceptionV4/InceptionV4/Mixed_4a/concat	Concat	CPU	2907	121084	123991
Iter 13: InceptionV4/InceptionV4/Mixed_5a/Branch_0/Conv2d_1a_3x3/Conv2D	Convolution	CPU	37378	124047	161425
Iter 14: InceptionV4/InceptionV4/Mixed_5a/Branch_1/MaxPool_1a_3x3/MaxPool	Pooling	CPU	1344	161599	162943
Iter 15: InceptionV4/InceptionV4/Mixed_5a/concat	Concat	CPU	1087	163041	164128
Iter 16: InceptionV4/InceptionV4/Mixed_5b/Branch_0/Conv2d_0a_1x1/Conv2D	Convolution	CPU	3899	164308	168207
Iter 17: InceptionV4/InceptionV4/Mixed_5b/Branch_1/Conv2d_0a_1x1/Conv2D	Convolution	OpenCL	5736	164220	169956
Iter 18: InceptionV4/InceptionV4/Mixed_5b/Branch_2/Conv2d_0a_1x1/Conv2D	Convolution	CPU	2758	168341	171099
Iter 19: InceptionV4/InceptionV4/Mixed_5b/Branch_2/Conv2d_0b_3x3/Conv2D	Convolution	CPU	5260	171223	176483
Iter 20: InceptionV4/InceptionV4/Mixed_5b/Branch_1/Conv2d_0b_3x3/Conv2D	Convolution	OpenCL	8666	170066	178732
Iter 21: InceptionV4/InceptionV4/Mixed_5b/Branch_2/Conv2d_0c_3x3/Conv2D	Convolution	CPU	6408	176770	183178
Iter 22: InceptionV4/InceptionV4/Mixed_5b/Branch_3/AvgPool_0a_3x3/AvgPool	Pooling	CPU	1889	183444	185333
Iter 23: InceptionV4/InceptionV4/Mixed_5b/Branch_3/Conv2d_0b_1x1/Conv2D	Convolution	CPU	3840	185442	189282
Iter 24: InceptionV4/InceptionV4/Mixed_5b/concat	Concat	CPU	1383	189432	190815
Iter 25: InceptionV4/InceptionV4/Mixed_5c/Branch_0/Conv2d_0a_1x1/Conv2D	Convolution	CPU	3989	190887	194876
Iter 26: InceptionV4/InceptionV4/Mixed_5c/Branch_3/AvgPool_0a_3x3/AvgPool	Pooling	OpenCL	6013	190942	196955
Iter 27: InceptionV4/InceptionV4/Mixed_5c/Branch_1/Conv2d_0a_1x1/Conv2D	Convolution	CPU	2950	195042	197992
Iter 28: InceptionV4/InceptionV4/Mixed_5c/Branch_1/Conv2d_0b_3x3/Conv2D	Convolution	CPU	4049	198081	202130
Iter 29: InceptionV4/InceptionV4/Mixed_5c/Branch_3/Conv2d_0b_1x1/Conv2D	Convolution	OpenCL	6284	197048	203332
Iter 30: InceptionV4/InceptionV4/Mixed_5c/Branch_2/Conv2d_0a_1x1/Conv2D	Convolution	CPU	2752	202264	205016
Iter 31: InceptionV4/InceptionV4/Mixed_5c/Branch_2/Conv2d_0b_3x3/Conv2D	Convolution	CPU	3829	205118	208947
Iter 32: InceptionV4/InceptionV4/Mixed_5c/Branch_2/Conv2d_0c_3x3/Conv2D	Convolution	CPU	5541	209213	214754
Iter 33: InceptionV4/InceptionV4/Mixed_5c/concat	Concat	CPU	1387	214999	216386
Iter 34: InceptionV4/InceptionV4/Mixed_5d/Branch_0/Conv2d_0a_1x1/Conv2D	Convolution	CPU	4069	216446	220515
Iter 35: InceptionV4/InceptionV4/Mixed_5d/Branch_3/AvgPool_0a_3x3/AvgPool	Pooling	OpenCL	5913	216664	222577
Iter 36: InceptionV4/InceptionV4/Mixed_5d/Branch_1/Conv2d_0a_1x1/Conv2D	Convolution	CPU	2810	220668	223478
Iter 37: InceptionV4/InceptionV4/Mixed_5d/Branch_1/Conv2d_0b_3x3/Conv2D	Convolution	CPU	3971	223570	227541
Iter 38: InceptionV4/InceptionV4/Mixed_5d/Branch_3/Conv2d_0b_1x1/Conv2D	Convolution	OpenCL	6941	222673	229614
Iter 39: InceptionV4/InceptionV4/Mixed_5d/Branch_2/Conv2d_0a_1x1/Conv2D	Convolution	CPU	2760	227665	230425
Iter 40: InceptionV4/InceptionV4/Mixed_5d/Branch_2/Conv2d_0b_3x3/Conv2D	Convolution	CPU	3804	230517	234321
Iter 41: InceptionV4/InceptionV4/Mixed_5d/Branch_2/Conv2d_0c_3x3/Conv2D	Convolution	CPU	5633	234615	240248
Iter 42: InceptionV4/InceptionV4/Mixed_5d/concat	Concat	CPU	1521	240444	241965
Iter 43: InceptionV4/InceptionV4/Mixed_5e/Branch_0/Conv2d_0a_1x1/Conv2D	Convolution	CPU	4015	242033	246048
Iter 44: InceptionV4/InceptionV4/Mixed_5e/Branch_3/AvgPool_0a_3x3/AvgPool	Pooling	OpenCL	5816	242181	247997
Iter 45: InceptionV4/InceptionV4/Mixed_5e/Branch_1/Conv2d_0a_1x1/Conv2D	Convolution	CPU	2912	246210	249122
Iter 46: InceptionV4/InceptionV4/Mixed_5e/Branch_1/Conv2d_0b_3x3/Conv2D	Convolution	CPU	3964	249212	253176
Iter 47: InceptionV4/InceptionV4/Mixed_5e/Branch_3/Conv2d_0b_1x1/Conv2D	Convolution	OpenCL	6422	248095	254517
Iter 48: InceptionV4/InceptionV4/Mixed_5e/Branch_2/Conv2d_0a_1x1/Conv2D	Convolution	CPU	2790	253316	256106
Iter 49: InceptionV4/InceptionV4/Mixed_5e/Branch_2/Conv2d_0b_3x3/Conv2D	Convolution	CPU	3808	256205	260013
Iter 50: InceptionV4/InceptionV4/Mixed_5e/Branch_2/Conv2d_0c_3x3/Conv2D	Convolution	CPU	5459	260310	265769
Iter 51: InceptionV4/InceptionV4/Mixed_5e/concat	Concat	CPU	1326	266061	267387
Iter 52: InceptionV4/InceptionV4/Mixed_6a/Branch_1/Conv2d_0a_1x1/Conv2D	Convolution	CPU	7531	267445	274976
Iter 53: InceptionV4/InceptionV4/Mixed_6a/Branch_1/Conv2d_0b_3x3/Conv2D	Convolution	CPU	27153	275133	302286
Iter 54: InceptionV4/InceptionV4/Mixed_6a/Branch_1/Conv2d_1a_3x3/Conv2D	Convolution	CPU	17135	302441	319576
Iter 55: InceptionV4/InceptionV4/Mixed_6a/Branch_2/MaxPool_1a_3x3/MaxPool	Pooling	CPU	717	319710	320427
Iter 56: InceptionV4/InceptionV4/Mixed_6a/Branch_0/Conv2d_1a_3x3/Conv2D	Convolution	OpenCL	72971	267603	340574
Iter 57: InceptionV4/InceptionV4/Mixed_6a/concat	Concat	CPU	21028	320535	341563
Iter 58: InceptionV4/InceptionV4/Mixed_6b/Branch_1/Conv2d_0a_1x1/Conv2D	Convolution	OpenCL	9211	341797	351008
Iter 59: InceptionV4/InceptionV4/Mixed_6b/Branch_0/Conv2d_0a_1x1/Conv2D	Convolution	CPU	13020	341614	354634
Iter 60: InceptionV4/InceptionV4/Mixed_6b/Branch_2/Conv2d_0a_1x1/Conv2D	Convolution	CPU	6802	354732	361534
Iter 61: InceptionV4/InceptionV4/Mixed_6b/Branch_1/Conv2d_0b_1x7/Conv2D	Convolution	OpenCL	15861	351122	366983
Iter 62: InceptionV4/InceptionV4/Mixed_6b/Branch_2/Conv2d_0b_7x1/Conv2D	Convolution	CPU	8041	361678	369719
Iter 63: InceptionV4/InceptionV4/Mixed_6b/Branch_2/Conv2d_0c_1x7/Conv2D	Convolution	CPU	8837	369831	378668
Iter 64: InceptionV4/InceptionV4/Mixed_6b/Branch_1/Conv2d_0c_7x1/Conv2D	Convolution	OpenCL	19596	367110	386706
Iter 65: InceptionV4/InceptionV4/Mixed_6b/Branch_2/Conv2d_0d_7x1/Conv2D	Convolution	CPU	11555	378794	390349
Iter 66: InceptionV4/InceptionV4/Mixed_6b/Branch_3/AvgPool_0a_3x3/AvgPool	Pooling	OpenCL	7394	386895	394289
Iter 67: InceptionV4/InceptionV4/Mixed_6b/Branch_3/Conv2d_0b_1x1/Conv2D	Convolution	OpenCL	5797	394413	400210
Iter 68: InceptionV4/InceptionV4/Mixed_6b/Branch_2/Conv2d_0e_1x7/Conv2D	Convolution	CPU	13797	390547	404344
Iter 69: InceptionV4/InceptionV4/Mixed_6b/concat	Concat	CPU	930	404548	405478
Iter 70: InceptionV4/InceptionV4/Mixed_6c/Branch_1/Conv2d_0a_1x1/Conv2D	Convolution	OpenCL	9270	405705	414975
Iter 71: InceptionV4/InceptionV4/Mixed_6c/Branch_0/Conv2d_0a_1x1/Conv2D	Convolution	CPU	13080	405535	418615
Iter 72: InceptionV4/InceptionV4/Mixed_6c/Branch_2/Conv2d_0a_1x1/Conv2D	Convolution	CPU	6754	418708	425462
Iter 73: InceptionV4/InceptionV4/Mixed_6c/Branch_1/Conv2d_0b_1x7/Conv2D	Convolution	OpenCL	15890	415089	430979
Iter 74: InceptionV4/InceptionV4/Mixed_6c/Branch_2/Conv2d_0b_7x1/Conv2D	Convolution	CPU	7991	425603	433594
Iter 75: InceptionV4/InceptionV4/Mixed_6c/Branch_2/Conv2d_0c_1x7/Conv2D	Convolution	CPU	8798	433703	442501
Iter 76: InceptionV4/InceptionV4/Mixed_6c/Branch_1/Conv2d_0c_7x1/Conv2D	Convolution	OpenCL	19543	431099	450642
Iter 77: InceptionV4/InceptionV4/Mixed_6c/Branch_2/Conv2d_0d_7x1/Conv2D	Convolution	CPU	11507	442641	454148
Iter 78: InceptionV4/InceptionV4/Mixed_6c/Branch_3/AvgPool_0a_3x3/AvgPool	Pooling	OpenCL	7289	450780	458069
Iter 79: InceptionV4/InceptionV4/Mixed_6c/Branch_3/Conv2d_0b_1x1/Conv2D	Convolution	OpenCL	5589	458183	463772
Iter 80: InceptionV4/InceptionV4/Mixed_6c/Branch_2/Conv2d_0e_1x7/Conv2D	Convolution	CPU	13769	454332	468101
Iter 81: InceptionV4/InceptionV4/Mixed_6c/concat	Concat	CPU	993	468234	469227
Iter 82: InceptionV4/InceptionV4/Mixed_6d/Branch_1/Conv2d_0a_1x1/Conv2D	Convolution	OpenCL	9295	469395	478690
Iter 83: InceptionV4/InceptionV4/Mixed_6d/Branch_0/Conv2d_0a_1x1/Conv2D	Convolution	CPU	13089	469291	482380
Iter 84: InceptionV4/InceptionV4/Mixed_6d/Branch_2/Conv2d_0a_1x1/Conv2D	Convolution	CPU	6723	482481	489204
Iter 85: InceptionV4/InceptionV4/Mixed_6d/Branch_1/Conv2d_0b_1x7/Conv2D	Convolution	OpenCL	15820	478803	494623
Iter 86: InceptionV4/InceptionV4/Mixed_6d/Branch_2/Conv2d_0b_7x1/Conv2D	Convolution	CPU	8101	489345	497446
Iter 87: InceptionV4/InceptionV4/Mixed_6d/Branch_2/Conv2d_0c_1x7/Conv2D	Convolution	CPU	8741	497555	506296
Iter 88: InceptionV4/InceptionV4/Mixed_6d/Branch_1/Conv2d_0c_7x1/Conv2D	Convolution	OpenCL	19712	494774	514486
Iter 89: InceptionV4/InceptionV4/Mixed_6d/Branch_2/Conv2d_0d_7x1/Conv2D	Convolution	CPU	11815	506438	518253
Iter 90: InceptionV4/InceptionV4/Mixed_6d/Branch_3/AvgPool_0a_3x3/AvgPool	Pooling	OpenCL	7333	514608	521941
Iter 91: InceptionV4/InceptionV4/Mixed_6d/Branch_3/Conv2d_0b_1x1/Conv2D	Convolution	OpenCL	5657	522050	527707
Iter 92: InceptionV4/InceptionV4/Mixed_6d/Branch_2/Conv2d_0e_1x7/Conv2D	Convolution	CPU	13658	518446	532104
Iter 93: InceptionV4/Logits/PreLogitsFlatten/flatten/strided_slice/stack	Const	CPU	1	532354	532355
Iter 94: InceptionV4/Logits/PreLogitsFlatten/flatten/strided_slice/stack_1	Const	CPU	1	532410	532411
Iter 95: InceptionV4/Logits/PreLogitsFlatten/flatten/strided_slice/stack_2	Const	CPU	1	532471	532472
Iter 96: InceptionV4/Logits/PreLogitsFlatten/flatten/Reshape/shape/1	Const	CPU	0	532529	532529
Iter 97: InceptionV4/Logits/Logits/weights	Const	CPU	1	532591	532592
Iter 98: InceptionV4/Logits/Logits/biases	Const	CPU	1	532641	532642
Iter 99: InceptionV4/InceptionV4/Mixed_6d/concat	Concat	OpenCL	2146	532315	534461
Iter 100: InceptionV4/InceptionV4/Mixed_6e/Branch_1/Conv2d_0a_1x1/Conv2D	Convolution	OpenCL	7805	534527	542332
Iter 101: InceptionV4/InceptionV4/Mixed_6e/Branch_0/Conv2d_0a_1x1/Conv2D	Convolution	CPU	21636	534616	556252
Iter 102: InceptionV4/InceptionV4/Mixed_6e/Branch_1/Conv2d_0b_1x7/Conv2D	Convolution	OpenCL	15696	542383	558079
Iter 103: InceptionV4/InceptionV4/Mixed_6e/Branch_2/Conv2d_0a_1x1/Conv2D	Convolution	CPU	9515	556423	565938
Iter 104: InceptionV4/InceptionV4/Mixed_6e/Branch_2/Conv2d_0b_7x1/Conv2D	Convolution	CPU	7870	566081	573951
Iter 105: InceptionV4/InceptionV4/Mixed_6e/Branch_1/Conv2d_0c_7x1/Conv2D	Convolution	OpenCL	19989	558142	578131
Iter 106: InceptionV4/InceptionV4/Mixed_6e/Branch_3/AvgPool_0a_3x3/AvgPool	Pooling	OpenCL	6334	578248	584582
Iter 107: InceptionV4/InceptionV4/Mixed_6e/Branch_2/Conv2d_0c_1x7/Conv2D	Convolution	CPU	11890	574104	585994
Iter 108: InceptionV4/InceptionV4/Mixed_6e/Branch_3/Conv2d_0b_1x1/Conv2D	Convolution	OpenCL	5810	584698	590508
Iter 109: InceptionV4/InceptionV4/Mixed_6e/Branch_2/Conv2d_0d_7x1/Conv2D	Convolution	CPU	10647	586088	596735
Iter 110: InceptionV4/InceptionV4/Mixed_6e/Branch_2/Conv2d_0e_1x7/Conv2D	Convolution	CPU	11306	596892	608198
Iter 111: InceptionV4/InceptionV4/Mixed_6e/concat	Concat	CPU	944	608391	609335
Iter 112: InceptionV4/InceptionV4/Mixed_6f/Branch_1/Conv2d_0a_1x1/Conv2D	Convolution	OpenCL	9509	609464	618973
Iter 113: InceptionV4/InceptionV4/Mixed_6f/Branch_0/Conv2d_0a_1x1/Conv2D	Convolution	CPU	13142	609507	622649
Iter 114: InceptionV4/InceptionV4/Mixed_6f/Branch_2/Conv2d_0a_1x1/Conv2D	Convolution	CPU	6706	622752	629458
Iter 115: InceptionV4/InceptionV4/Mixed_6f/Branch_1/Conv2d_0b_1x7/Conv2D	Convolution	OpenCL	15976	619102	635078
Iter 116: InceptionV4/InceptionV4/Mixed_6f/Branch_2/Conv2d_0b_7x1/Conv2D	Convolution	CPU	8002	629594	637596
Iter 117: InceptionV4/InceptionV4/Mixed_6f/Branch_2/Conv2d_0c_1x7/Conv2D	Convolution	CPU	8811	637710	646521
Iter 118: InceptionV4/InceptionV4/Mixed_6f/Branch_1/Conv2d_0c_7x1/Conv2D	Convolution	OpenCL	20431	635189	655620
Iter 119: InceptionV4/InceptionV4/Mixed_6f/Branch_2/Conv2d_0d_7x1/Conv2D	Convolution	CPU	11613	646717	658330
Iter 120: InceptionV4/InceptionV4/Mixed_6f/Branch_3/AvgPool_0a_3x3/AvgPool	Pooling	OpenCL	7310	655747	663057
Iter 121: InceptionV4/InceptionV4/Mixed_6f/Branch_3/Conv2d_0b_1x1/Conv2D	Convolution	OpenCL	5743	663171	668914
Iter 122: InceptionV4/InceptionV4/Mixed_6f/Branch_2/Conv2d_0e_1x7/Conv2D	Convolution	CPU	14173	658508	672681
Iter 123: InceptionV4/InceptionV4/Mixed_6f/concat	Concat	OpenCL	1907	672969	674876
Iter 124: InceptionV4/InceptionV4/Mixed_6g/Branch_1/Conv2d_0a_1x1/Conv2D	Convolution	OpenCL	7589	674937	682526
Iter 125: InceptionV4/InceptionV4/Mixed_6g/Branch_0/Conv2d_0a_1x1/Conv2D	Convolution	CPU	21371	675034	696405
Iter 126: InceptionV4/InceptionV4/Mixed_6g/Branch_1/Conv2d_0b_1x7/Conv2D	Convolution	OpenCL	15601	682578	698179
Iter 127: InceptionV4/InceptionV4/Mixed_6g/Branch_2/Conv2d_0a_1x1/Conv2D	Convolution	CPU	10040	696567	706607
Iter 128: InceptionV4/InceptionV4/Mixed_6g/Branch_2/Conv2d_0b_7x1/Conv2D	Convolution	CPU	7897	706801	714698
Iter 129: InceptionV4/InceptionV4/Mixed_6g/Branch_1/Conv2d_0c_7x1/Conv2D	Convolution	OpenCL	20591	698244	718835
Iter 130: InceptionV4/InceptionV4/Mixed_6g/Branch_3/AvgPool_0a_3x3/AvgPool	Pooling	OpenCL	6264	718954	725218
Iter 131: InceptionV4/InceptionV4/Mixed_6g/Branch_2/Conv2d_0c_1x7/Conv2D	Convolution	CPU	11924	714918	726842
Iter 132: InceptionV4/InceptionV4/Mixed_6g/Branch_3/Conv2d_0b_1x1/Conv2D	Convolution	OpenCL	5641	725335	730976
Iter 133: InceptionV4/InceptionV4/Mixed_6g/Branch_2/Conv2d_0d_7x1/Conv2D	Convolution	CPU	10540	726938	737478
Iter 134: InceptionV4/InceptionV4/Mixed_6g/Branch_2/Conv2d_0e_1x7/Conv2D	Convolution	CPU	11505	737622	749127
Iter 135: InceptionV4/InceptionV4/Mixed_6g/concat	Concat	OpenCL	2021	749307	751328
Iter 136: InceptionV4/InceptionV4/Mixed_6h/Branch_1/Conv2d_0a_1x1/Conv2D	Convolution	OpenCL	8252	751390	759642
Iter 137: InceptionV4/InceptionV4/Mixed_6h/Branch_0/Conv2d_0a_1x1/Conv2D	Convolution	CPU	22090	751485	773575
Iter 138: InceptionV4/InceptionV4/Mixed_6h/Branch_1/Conv2d_0b_1x7/Conv2D	Convolution	OpenCL	15688	759696	775384
Iter 139: InceptionV4/InceptionV4/Mixed_6h/Branch_2/Conv2d_0a_1x1/Conv2D	Convolution	CPU	9157	773733	782890
Iter 140: InceptionV4/InceptionV4/Mixed_6h/Branch_2/Conv2d_0b_7x1/Conv2D	Convolution	CPU	7808	783030	790838
Iter 141: InceptionV4/InceptionV4/Mixed_6h/Branch_1/Conv2d_0c_7x1/Conv2D	Convolution	OpenCL	20608	775462	796070
Iter 142: InceptionV4/InceptionV4/Mixed_6h/Branch_3/AvgPool_0a_3x3/AvgPool	Pooling	OpenCL	6201	796203	802404
Iter 143: InceptionV4/InceptionV4/Mixed_6h/Branch_2/Conv2d_0c_1x7/Conv2D	Convolution	CPU	13448	790980	804428
Iter 144: InceptionV4/InceptionV4/Mixed_6h/Branch_3/Conv2d_0b_1x1/Conv2D	Convolution	OpenCL	5634	802494	808128
Iter 145: InceptionV4/InceptionV4/Mixed_6h/Branch_2/Conv2d_0d_7x1/Conv2D	Convolution	CPU	10383	804522	814905
Iter 146: InceptionV4/InceptionV4/Mixed_6h/Branch_2/Conv2d_0e_1x7/Conv2D	Convolution	CPU	11278	815077	826355
Iter 147: InceptionV4/InceptionV4/Mixed_6h/concat	Concat	OpenCL	1904	826686	828590
Iter 148: InceptionV4/InceptionV4/Mixed_7a/Branch_0/Conv2d_0a_1x1/Conv2D	Convolution	OpenCL	7556	828656	836212
Iter 149: InceptionV4/InceptionV4/Mixed_7a/Branch_0/Conv2d_1a_3x3/Conv2D	Convolution	OpenCL	4258	836262	840520
Iter 150: InceptionV4/InceptionV4/Mixed_7a/Branch_2/MaxPool_1a_3x3/MaxPool	Pooling	OpenCL	2307	840633	842940
Iter 151: InceptionV4/InceptionV4/Mixed_7a/Branch_1/Conv2d_0a_1x1/Conv2D	Convolution	CPU	18750	828741	847491
Iter 152: InceptionV4/InceptionV4/Mixed_7a/Branch_1/Conv2d_0b_1x7/Conv2D	Convolution	CPU	13303	847699	861002
Iter 153: InceptionV4/InceptionV4/Mixed_7a/Branch_1/Conv2d_0c_7x1/Conv2D	Convolution	CPU	17005	861232	878237
Iter 154: InceptionV4/InceptionV4/Mixed_7a/Branch_1/Conv2d_1a_3x3/Conv2D	Convolution	CPU	8214	878378	886592
Iter 155: InceptionV4/InceptionV4/Mixed_7a/concat	Concat	CPU	464	886807	887271
Iter 156: InceptionV4/InceptionV4/Mixed_7b/Branch_0/Conv2d_0a_1x1/Conv2D	Convolution	OpenCL	3865	887471	891336
Iter 157: InceptionV4/InceptionV4/Mixed_7b/Branch_2/Conv2d_0a_1x1/Conv2D	Convolution	CPU	4800	887317	892117
Iter 158: InceptionV4/InceptionV4/Mixed_7b/Branch_1/Conv2d_0a_1x1/Conv2D	Convolution	OpenCL	5274	891564	896838
Iter 159: InceptionV4/InceptionV4/Mixed_7b/Branch_2/Conv2d_0b_3x1/Conv2D	Convolution	CPU	4855	892206	897061
Iter 160: InceptionV4/InceptionV4/Mixed_7b/Branch_1/Conv2d_0b_1x3/Conv2D	Convolution	OpenCL	3891	897017	900908
Iter 161: InceptionV4/InceptionV4/Mixed_7b/Branch_2/Conv2d_0c_1x3/Conv2D	Convolution	CPU	6730	897142	903872
Iter 162: InceptionV4/InceptionV4/Mixed_7b/Branch_1/Conv2d_0c_3x1/Conv2D	Convolution	OpenCL	3614	901129	904743
Iter 163: InceptionV4/InceptionV4/Mixed_7b/Branch_1/concat	Concat	OpenCL	1397	904871	906268
Iter 164: InceptionV4/InceptionV4/Mixed_7b/Branch_2/Conv2d_0d_1x3/Conv2D	Convolution	CPU	4082	903960	908042
Iter 165: InceptionV4/InceptionV4/Mixed_7b/Branch_3/AvgPool_0a_3x3/AvgPool	Pooling	OpenCL	2870	906390	909260
Iter 166: InceptionV4/InceptionV4/Mixed_7b/Branch_2/Conv2d_0e_3x1/Conv2D	Convolution	CPU	4001	908175	912176
Iter 167: InceptionV4/InceptionV4/Mixed_7b/Branch_2/concat	Concat	CPU	87	912284	912371
Iter 168: InceptionV4/InceptionV4/Mixed_7b/Branch_3/Conv2d_0b_1x1/Conv2D	Convolution	OpenCL	3193	909404	912597
Iter 169: InceptionV4/InceptionV4/Mixed_7b/concat	Concat	CPU	590	912409	912999
Iter 170: InceptionV4/InceptionV4/Mixed_7c/Branch_0/Conv2d_0a_1x1/Conv2D	Convolution	CPU	3498	913054	916552
Iter 171: InceptionV4/InceptionV4/Mixed_7c/Branch_1/Conv2d_0a_1x1/Conv2D	Convolution	OpenCL	5361	913193	918554
Iter 172: InceptionV4/InceptionV4/Mixed_7c/Branch_2/Conv2d_0a_1x1/Conv2D	Convolution	CPU	5148	916736	921884
Iter 173: InceptionV4/InceptionV4/Mixed_7c/Branch_1/Conv2d_0b_1x3/Conv2D	Convolution	OpenCL	3871	918720	922591
Iter 174: InceptionV4/InceptionV4/Mixed_7c/Branch_1/Conv2d_0c_3x1/Conv2D	Convolution	OpenCL	3575	922771	926346
Iter 175: InceptionV4/InceptionV4/Mixed_7c/Branch_2/Conv2d_0b_3x1/Conv2D	Convolution	CPU	4988	922033	927021
Iter 176: InceptionV4/InceptionV4/Mixed_7c/Branch_1/concat	Concat	OpenCL	1397	926525	927922
Iter 177: InceptionV4/InceptionV4/Mixed_7c/Branch_3/AvgPool_0a_3x3/AvgPool	Pooling	OpenCL	2987	928055	931042
Iter 178: InceptionV4/InceptionV4/Mixed_7c/Branch_2/Conv2d_0c_1x3/Conv2D	Convolution	CPU	6960	927118	934078
Iter 179: InceptionV4/InceptionV4/Mixed_7c/Branch_3/Conv2d_0b_1x1/Conv2D	Convolution	OpenCL	3166	931237	934403
Iter 180: InceptionV4/InceptionV4/Mixed_7c/Branch_2/Conv2d_0d_1x3/Conv2D	Convolution	CPU	3450	934170	937620
Iter 181: InceptionV4/InceptionV4/Mixed_7c/Branch_2/Conv2d_0e_3x1/Conv2D	Convolution	CPU	3366	937867	941233
Iter 182: InceptionV4/InceptionV4/Mixed_7c/Branch_2/concat	Concat	CPU	134	941367	941501
Iter 183: InceptionV4/InceptionV4/Mixed_7c/concat	Concat	CPU	345	941568	941913
Iter 184: InceptionV4/InceptionV4/Mixed_7d/Branch_0/Conv2d_0a_1x1/Conv2D	Convolution	CPU	3478	941963	945441
Iter 185: InceptionV4/InceptionV4/Mixed_7d/Branch_1/Conv2d_0a_1x1/Conv2D	Convolution	OpenCL	5393	942101	947494
Iter 186: InceptionV4/InceptionV4/Mixed_7d/Branch_2/Conv2d_0a_1x1/Conv2D	Convolution	CPU	5217	945575	950792
Iter 187: InceptionV4/InceptionV4/Mixed_7d/Branch_1/Conv2d_0b_1x3/Conv2D	Convolution	OpenCL	4709	947597	952306
Iter 188: InceptionV4/InceptionV4/Mixed_7d/Branch_2/Conv2d_0b_3x1/Conv2D	Convolution	CPU	5018	950943	955961
Iter 189: InceptionV4/InceptionV4/Mixed_7d/Branch_1/Conv2d_0c_3x1/Conv2D	Convolution	OpenCL	3574	952406	955980
Iter 190: InceptionV4/InceptionV4/Mixed_7d/Branch_1/concat	Concat	OpenCL	1368	956310	957678
Iter 191: InceptionV4/InceptionV4/Mixed_7d/Branch_3/AvgPool_0a_3x3/AvgPool	Pooling	OpenCL	2722	957795	960517
Iter 192: InceptionV4/InceptionV4/Mixed_7d/Branch_2/Conv2d_0c_1x3/Conv2D	Convolution	CPU	7146	956070	963216
Iter 193: InceptionV4/InceptionV4/Mixed_7d/Branch_3/Conv2d_0b_1x1/Conv2D	Convolution	OpenCL	3359	960615	963974
Iter 194: InceptionV4/InceptionV4/Mixed_7d/Branch_2/Conv2d_0d_1x3/Conv2D	Convolution	CPU	3437	963299	966736
Iter 195: InceptionV4/InceptionV4/Mixed_7d/Branch_2/Conv2d_0e_3x1/Conv2D	Convolution	CPU	3325	966835	970160
Iter 196: InceptionV4/InceptionV4/Mixed_7d/Branch_2/concat	Concat	CPU	74	970288	970362
Iter 197: InceptionV4/InceptionV4/Mixed_7d/concat	Concat	CPU	335	970408	970743
Iter 198: InceptionV4/Logits/AvgPool_1a/AvgPool	Pooling	CPU	165	970790	970955
Iter 199: InceptionV4/Logits/PreLogitsFlatten/flatten/Shape	Shape	CPU	1	971018	971019
Iter 200: InceptionV4/Logits/PreLogitsFlatten/flatten/strided_slice	StridedSlice	CPU	1	971063	971064
Iter 201: InceptionV4/Logits/PreLogitsFlatten/flatten/Reshape/shape	Pack	CPU	0	971115	971115
Iter 202: InceptionV4/Logits/AvgPool_1a/AvgPool___tr4InceptionV4/Logits/PreLogitsFlatten/flatten/Reshape	ConvertTensor	CPU	5	971168	971173
Iter 203: InceptionV4/Logits/PreLogitsFlatten/flatten/Reshape	Reshape	CPU	3	971223	971226
Iter 204: InceptionV4/Logits/Logits/MatMul	MatMul	CPU	15250	971276	986526
Iter 205: InceptionV4/Logits/Logits/BiasAdd	BinaryOp	CPU	33	986664	986697
Iter 206: InceptionV4/Logits/Predictions	Softmax	CPU	21	986747	986768
Iter 0: InceptionV4/InceptionV4/Conv2d_1a_3x3/Conv2D	Convolution	CPU	4008	351	4359
Iter 1: InceptionV4/InceptionV4/Conv2d_2a_3x3/Conv2D	Convolution	CPU	11110	4544	15654
Iter 2: InceptionV4/InceptionV4/Conv2d_2b_3x3/Conv2D	Convolution	CPU	21392	15831	37223
Iter 3: InceptionV4/InceptionV4/Mixed_3a/Branch_0/MaxPool_0a_3x3/MaxPool	Pooling	CPU	1678	37380	39058
Iter 4: InceptionV4/InceptionV4/Mixed_3a/Branch_1/Conv2d_0a_3x3/Conv2D	Convolution	CPU	27471	39165	66636
Iter 5: InceptionV4/InceptionV4/Mixed_3a/concat	Concat	CPU	1899	66801	68700
Iter 6: InceptionV4/InceptionV4/Mixed_4a/Branch_1/Conv2d_0a_1x1/Conv2D	Convolution	CPU	4660	68760	73420
Iter 7: InceptionV4/InceptionV4/Mixed_4a/Branch_0/Conv2d_0a_1x1/Conv2D	Convolution	OpenCL	13407	68897	82304
Iter 8: InceptionV4/InceptionV4/Mixed_4a/Branch_1/Conv2d_0b_1x7/Conv2D	Convolution	CPU	14654	73543	88197
Iter 9: InceptionV4/InceptionV4/Mixed_4a/Branch_1/Conv2d_0c_7x1/Conv2D	Convolution	CPU	15881	88355	104236
Iter 10: InceptionV4/InceptionV4/Mixed_4a/Branch_0/Conv2d_1a_3x3/Conv2D	Convolution	OpenCL	29132	82471	111603
Iter 11: InceptionV4/InceptionV4/Mixed_4a/Branch_1/Conv2d_1a_3x3/Conv2D	Convolution	CPU	15078	104499	119577
Iter 12: InceptionV4/InceptionV4/Mixed_4a/concat	Concat	CPU	3032	119742	122774
Iter 13: InceptionV4/InceptionV4/Mixed_5a/Branch_0/Conv2d_1a_3x3/Conv2D	Convolution	CPU	37231	122827	160058
Iter 14: InceptionV4/InceptionV4/Mixed_5a/Branch_1/MaxPool_1a_3x3/MaxPool	Pooling	CPU	1373	160223	161596
Iter 15: InceptionV4/InceptionV4/Mixed_5a/concat	Concat	CPU	1088	161688	162776
Iter 16: InceptionV4/InceptionV4/Mixed_5b/Branch_0/Conv2d_0a_1x1/Conv2D	Convolution	CPU	3812	162849	166661
Iter 17: InceptionV4/InceptionV4/Mixed_5b/Branch_1/Conv2d_0a_1x1/Conv2D	Convolution	OpenCL	5746	162900	168646
Iter 18: InceptionV4/InceptionV4/Mixed_5b/Branch_2/Conv2d_0a_1x1/Conv2D	Convolution	CPU	2732	166812	169544
Iter 19: InceptionV4/InceptionV4/Mixed_5b/Branch_2/Conv2d_0b_3x3/Conv2D	Convolution	CPU	5303	169651	174954
Iter 20: InceptionV4/InceptionV4/Mixed_5b/Branch_1/Conv2d_0b_3x3/Conv2D	Convolution	OpenCL	8999	168740	177739
Iter 21: InceptionV4/InceptionV4/Mixed_5b/Branch_2/Conv2d_0c_3x3/Conv2D	Convolution	CPU	6619	175145	181764
Iter 22: InceptionV4/InceptionV4/Mixed_5b/Branch_3/AvgPool_0a_3x3/AvgPool	Pooling	CPU	1856	181935	183791
Iter 23: InceptionV4/InceptionV4/Mixed_5b/Branch_3/Conv2d_0b_1x1/Conv2D	Convolution	CPU	3784	183900	187684
Iter 24: InceptionV4/InceptionV4/Mixed_5b/concat	Concat	CPU	1506	187836	189342
Iter 25: InceptionV4/InceptionV4/Mixed_5c/Branch_0/Conv2d_0a_1x1/Conv2D	Convolution	CPU	4021	189399	193420
Iter 26: InceptionV4/InceptionV4/Mixed_5c/Branch_3/AvgPool_0a_3x3/AvgPool	Pooling	OpenCL	5966	189594	195560
Iter 27: InceptionV4/InceptionV4/Mixed_5c/Branch_1/Conv2d_0a_1x1/Conv2D	Convolution	CPU	2961	193589	196550
Iter 28: InceptionV4/InceptionV4/Mixed_5c/Branch_1/Conv2d_0b_3x3/Conv2D	Convolution	CPU	4202	196637	200839
Iter 29: InceptionV4/InceptionV4/Mixed_5c/Branch_3/Conv2d_0b_1x1/Conv2D	Convolution	OpenCL	6340	195665	202005
Iter 30: InceptionV4/InceptionV4/Mixed_5c/Branch_2/Conv2d_0a_1x1/Conv2D	Convolution	CPU	2730	200970	203700
Iter 31: InceptionV4/InceptionV4/Mixed_5c/Branch_2/Conv2d_0b_3x3/Conv2D	Convolution	CPU	3735	203801	207536
Iter 32: InceptionV4/InceptionV4/Mixed_5c/Branch_2/Conv2d_0c_3x3/Conv2D	Convolution	CPU	5608	207748	213356
Iter 33: InceptionV4/InceptionV4/Mixed_5c/concat	Concat	CPU	1379	213621	215000
Iter 34: InceptionV4/InceptionV4/Mixed_5d/Branch_0/Conv2d_0a_1x1/Conv2D	Convolution	CPU	4049	215068	219117
Iter 35: InceptionV4/InceptionV4/Mixed_5d/Branch_3/AvgPool_0a_3x3/AvgPool	Pooling	OpenCL	5995	215139	221134
Iter 36: InceptionV4/InceptionV4/Mixed_5d/Branch_1/Conv2d_0a_1x1/Conv2D	Convolution	CPU	2868	219276	222144
Iter 37: InceptionV4/InceptionV4/Mixed_5d/Branch_1/Conv2d_0b_3x3/Conv2D	Convolution	CPU	3964	222235	226199
Iter 38: InceptionV4/InceptionV4/Mixed_5d/Branch_3/Conv2d_0b_1x1/Conv2D	Convolution	OpenCL	6970	221230	228200
Iter 39: InceptionV4/InceptionV4/Mixed_5d/Branch_2/Conv2d_0a_1x1/Conv2D	Convolution	CPU	2823	226327	229150
Iter 40: InceptionV4/InceptionV4/Mixed_5d/Branch_2/Conv2d_0b_3x3/Conv2D	Convolution	CPU	3821	229249	233070
Iter 41: InceptionV4/InceptionV4/Mixed_5d/Branch_2/Conv2d_0c_3x3/Conv2D	Convolution	CPU	5707	233240	238947
Iter 42: InceptionV4/InceptionV4/Mixed_5d/concat	Concat	CPU	1386	239099	240485
Iter 43: InceptionV4/InceptionV4/Mixed_5e/Branch_0/Conv2d_0a_1x1/Conv2D	Convolution	CPU	3993	240541	244534
Iter 44: InceptionV4/InceptionV4/Mixed_5e/Branch_3/AvgPool_0a_3x3/AvgPool	Pooling	OpenCL	6039	240710	246749
Iter 45: InceptionV4/InceptionV4/Mixed_5e/Branch_1/Conv2d_0a_1x1/Conv2D	Convolution	CPU	2834	244695	247529
Iter 46: InceptionV4/InceptionV4/Mixed_5e/Branch_1/Conv2d_0b_3x3/Conv2D	Convolution	CPU	4031	247616	251647
Iter 47: InceptionV4/InceptionV4/Mixed_5e/Branch_3/Conv2d_0b_1x1/Conv2D	Convolution	OpenCL	6384	246843	253227
Iter 48: InceptionV4/InceptionV4/Mixed_5e/Branch_2/Conv2d_0a_1x1/Conv2D	Convolution	CPU	2793	251795	254588
Iter 49: InceptionV4/InceptionV4/Mixed_5e/Branch_2/Conv2d_0b_3x3/Conv2D	Convolution	CPU	3859	254683	258542
Iter 50: InceptionV4/InceptionV4/Mixed_5e/Branch_2/Conv2d_0c_3x3/Conv2D	Convolution	CPU	5553	258680	264233
Iter 51: InceptionV4/InceptionV4/Mixed_5e/concat	Concat	CPU	1408	264404	265812
Iter 52: InceptionV4/InceptionV4/Mixed_6a/Branch_1/Conv2d_0a_1x1/Conv2D	Convolution	CPU	7603	265870	273473
Iter 53: InceptionV4/InceptionV4/Mixed_6a/Branch_1/Conv2d_0b_3x3/Conv2D	Convolution	CPU	26546	273628	300174
Iter 54: InceptionV4/InceptionV4/Mixed_6a/Branch_1/Conv2d_1a_3x3/Conv2D	Convolution	CPU	17078	300323	317401
Iter 55: InceptionV4/InceptionV4/Mixed_6a/Branch_2/MaxPool_1a_3x3/MaxPool	Pooling	CPU	859	317554	318413
Iter 56: InceptionV4/InceptionV4/Mixed_6a/Branch_0/Conv2d_1a_3x3/Conv2D	Convolution	OpenCL	73123	266036	339159
Iter 57: InceptionV4/InceptionV4/Mixed_6a/concat	Concat	CPU	21649	318521	340170
Iter 58: InceptionV4/InceptionV4/Mixed_6b/Branch_1/Conv2d_0a_1x1/Conv2D	Convolution	OpenCL	9473	340329	349802
Iter 59: InceptionV4/InceptionV4/Mixed_6b/Branch_0/Conv2d_0a_1x1/Conv2D	Convolution	CPU	13084	340238	353322
Iter 60: InceptionV4/InceptionV4/Mixed_6b/Branch_2/Conv2d_0a_1x1/Conv2D	Convolution	CPU	6781	353413	360194
Iter 61: InceptionV4/InceptionV4/Mixed_6b/Branch_1/Conv2d_0b_1x7/Conv2D	Convolution	OpenCL	15876	349914	365790
Iter 62: InceptionV4/InceptionV4/Mixed_6b/Branch_2/Conv2d_0b_7x1/Conv2D	Convolution	CPU	8084	360337	368421
Iter 63: InceptionV4/InceptionV4/Mixed_6b/Branch_2/Conv2d_0c_1x7/Conv2D	Convolution	CPU	8774	368535	377309
Iter 64: InceptionV4/InceptionV4/Mixed_6b/Branch_1/Conv2d_0c_7x1/Conv2D	Convolution	OpenCL	19652	365898	385550
Iter 65: InceptionV4/InceptionV4/Mixed_6b/Branch_2/Conv2d_0d_7x1/Conv2D	Convolution	CPU	11616	377445	389061
Iter 66: InceptionV4/InceptionV4/Mixed_6b/Branch_3/AvgPool_0a_3x3/AvgPool	Pooling	OpenCL	7597	385738	393335
Iter 67: InceptionV4/InceptionV4/Mixed_6b/Branch_3/Conv2d_0b_1x1/Conv2D	Convolution	OpenCL	5789	393453	399242
Iter 68: InceptionV4/InceptionV4/Mixed_6b/Branch_2/Conv2d_0e_1x7/Conv2D	Convolution	CPU	13933	389247	403180
Iter 69: InceptionV4/InceptionV4/Mixed_6b/concat	Concat	CPU	912	403378	404290
Iter 70: InceptionV4/InceptionV4/Mixed_6c/Branch_1/Conv2d_0a_1x1/Conv2D	Convolution	OpenCL	9322	404518	413840
Iter 71: InceptionV4/InceptionV4/Mixed_6c/Branch_0/Conv2d_0a_1x1/Conv2D	Convolution	CPU	12972	404347	417319
Iter 72: InceptionV4/InceptionV4/Mixed_6c/Branch_2/Conv2d_0a_1x1/Conv2D	Convolution	CPU	6771	417413	424184
Iter 73: InceptionV4/InceptionV4/Mixed_6c/Branch_1/Conv2d_0b_1x7/Conv2D	Convolution	OpenCL	15840	413970	429810
Iter 74: InceptionV4/InceptionV4/Mixed_6c/Branch_2/Conv2d_0b_7x1/Conv2D	Convolution	CPU	8003	424328	432331
Iter 75: InceptionV4/InceptionV4/Mixed_6c/Branch_2/Conv2d_0c_1x7/Conv2D	Convolution	CPU	8817	432448	441265
Iter 76: InceptionV4/InceptionV4/Mixed_6c/Branch_1/Conv2d_0c_7x1/Conv2D	Convolution	OpenCL	19707	429917	449624
Iter 77: InceptionV4/InceptionV4/Mixed_6c/Branch_2/Conv2d_0d_7x1/Conv2D	Convolution	CPU	11561	441403	452964
Iter 78: InceptionV4/InceptionV4/Mixed_6c/Branch_3/AvgPool_0a_3x3/AvgPool	Pooling	OpenCL	7340	449748	457088
Iter 79: InceptionV4/InceptionV4/Mixed_6c/Branch_3/Conv2d_0b_1x1/Conv2D	Convolution	OpenCL	5760	457191	462951
Iter 80: InceptionV4/InceptionV4/Mixed_6c/Branch_2/Conv2d_0e_1x7/Conv2D	Convolution	CPU	13817	453151	466968
Iter 81: InceptionV4/InceptionV4/Mixed_6c/concat	Concat	CPU	978	467130	468108
Iter 82: InceptionV4/InceptionV4/Mixed_6d/Branch_1/Conv2d_0a_1x1/Conv2D	Convolution	OpenCL	9307	468342	477649
Iter 83: InceptionV4/InceptionV4/Mixed_6d/Branch_0/Conv2d_0a_1x1/Conv2D	Convolution	CPU	12932	468163	481095
Iter 84: InceptionV4/InceptionV4/Mixed_6d/Branch_2/Conv2d_0a_1x1/Conv2D	Convolution	CPU	6679	481196	487875
Iter 85: InceptionV4/InceptionV4/Mixed_6d/Branch_1/Conv2d_0b_1x7/Conv2D	Convolution	OpenCL	15848	477761	493609
Iter 86: InceptionV4/InceptionV4/Mixed_6d/Branch_2/Conv2d_0b_7x1/Conv2D	Convolution	CPU	7941	488054	495995
Iter 87: InceptionV4/InceptionV4/Mixed_6d/Branch_2/Conv2d_0c_1x7/Conv2D	Convolution	CPU	8734	496105	504839
Iter 88: InceptionV4/InceptionV4/Mixed_6d/Branch_1/Conv2d_0c_7x1/Conv2D	Convolution	OpenCL	19832	493751	513583
Iter 89: InceptionV4/InceptionV4/Mixed_6d/Branch_2/Conv2d_0d_7x1/Conv2D	Convolution	CPU	11626	504990	516616
Iter 90: InceptionV4/InceptionV4/Mixed_6d/Branch_3/AvgPool_0a_3x3/AvgPool	Pooling	OpenCL	7294	513702	520996
Iter 91: InceptionV4/InceptionV4/Mixed_6d/Branch_3/Conv2d_0b_1x1/Conv2D	Convolution	OpenCL	5755	521102	526857
Iter 92: InceptionV4/InceptionV4/Mixed_6d/Branch_2/Conv2d_0e_1x7/Conv2D	Convolution	CPU	13921	516800	530721
Iter 93: InceptionV4/Logits/PreLogitsFlatten/flatten/strided_slice/stack	Const	CPU	1	530911	530912
Iter 94: InceptionV4/Logits/PreLogitsFlatten/flatten/strided_slice/stack_1	Const	CPU	1	530973	530974
Iter 95: InceptionV4/Logits/PreLogitsFlatten/flatten/strided_slice/stack_2	Const	CPU	1	531042	531043
Iter 96: InceptionV4/Logits/PreLogitsFlatten/flatten/Reshape/shape/1	Const	CPU	1	531121	531122
Iter 97: InceptionV4/Logits/Logits/weights	Const	CPU	1	531198	531199
Iter 98: InceptionV4/Logits/Logits/biases	Const	CPU	0	531261	531261
Iter 99: InceptionV4/InceptionV4/Mixed_6d/concat	Concat	OpenCL	1996	531368	533364
Iter 100: InceptionV4/InceptionV4/Mixed_6e/Branch_1/Conv2d_0a_1x1/Conv2D	Convolution	OpenCL	7736	533439	541175
Iter 101: InceptionV4/InceptionV4/Mixed_6e/Branch_0/Conv2d_0a_1x1/Conv2D	Convolution	CPU	21549	533514	555063
Iter 102: InceptionV4/InceptionV4/Mixed_6e/Branch_1/Conv2d_0b_1x7/Conv2D	Convolution	OpenCL	15718	541225	556943
Iter 103: InceptionV4/InceptionV4/Mixed_6e/Branch_2/Conv2d_0a_1x1/Conv2D	Convolution	CPU	9562	555223	564785
Iter 104: InceptionV4/InceptionV4/Mixed_6e/Branch_2/Conv2d_0b_7x1/Conv2D	Convolution	CPU	8142	564933	573075
Iter 105: InceptionV4/InceptionV4/Mixed_6e/Branch_1/Conv2d_0c_7x1/Conv2D	Convolution	OpenCL	20000	557006	577006
Iter 106: InceptionV4/InceptionV4/Mixed_6e/Branch_3/AvgPool_0a_3x3/AvgPool	Pooling	OpenCL	6375	577125	583500
Iter 107: InceptionV4/InceptionV4/Mixed_6e/Branch_2/Conv2d_0c_1x7/Conv2D	Convolution	CPU	12261	573206	585467
Iter 108: InceptionV4/InceptionV4/Mixed_6e/Branch_3/Conv2d_0b_1x1/Conv2D	Convolution	OpenCL	5835	583607	589442
Iter 109: InceptionV4/InceptionV4/Mixed_6e/Branch_2/Conv2d_0d_7x1/Conv2D	Convolution	CPU	10858	585556	596414
Iter 110: InceptionV4/InceptionV4/Mixed_6e/Branch_2/Conv2d_0e_1x7/Conv2D	Convolution	CPU	11615	596584	608199
Iter 111: InceptionV4/InceptionV4/Mixed_6e/concat	Concat	CPU	975	608344	609319
Iter 112: InceptionV4/InceptionV4/Mixed_6f/Branch_1/Conv2d_0a_1x1/Conv2D	Convolution	OpenCL	9420	609433	618853
Iter 113: InceptionV4/InceptionV4/Mixed_6f/Branch_0/Conv2d_0a_1x1/Conv2D	Convolution	CPU	13535	609376	622911
Iter 114: InceptionV4/InceptionV4/Mixed_6f/Branch_2/Conv2d_0a_1x1/Conv2D	Convolution	CPU	7070	623025	630095
Iter 115: InceptionV4/InceptionV4/Mixed_6f/Branch_1/Conv2d_0b_1x7/Conv2D	Convolution	OpenCL	16020	618954	634974
Iter 116: InceptionV4/InceptionV4/Mixed_6f/Branch_2/Conv2d_0b_7x1/Conv2D	Convolution	CPU	8310	630234	638544
Iter 117: InceptionV4/InceptionV4/Mixed_6f/Branch_2/Conv2d_0c_1x7/Conv2D	Convolution	CPU	9180	638654	647834
Iter 118: InceptionV4/InceptionV4/Mixed_6f/Branch_1/Conv2d_0c_7x1/Conv2D	Convolution	OpenCL	20476	635086	655562
Iter 119: InceptionV4/InceptionV4/Mixed_6f/Branch_2/Conv2d_0d_7x1/Conv2D	Convolution	CPU	12876	648031	660907
Iter 120: InceptionV4/InceptionV4/Mixed_6f/Branch_3/AvgPool_0a_3x3/AvgPool	Pooling	OpenCL	7741	655675	663416
Iter 121: InceptionV4/InceptionV4/Mixed_6f/Branch_3/Conv2d_0b_1x1/Conv2D	Convolution	OpenCL	5669	663530	669199
Iter 122: InceptionV4/InceptionV4/Mixed_6f/Branch_2/Conv2d_0e_1x7/Conv2D	Convolution	CPU	12885	661104	673989
Iter 123: InceptionV4/InceptionV4/Mixed_6f/concat	Concat	OpenCL	2055	674259	676314
Iter 124: InceptionV4/InceptionV4/Mixed_6g/Branch_1/Conv2d_0a_1x1/Conv2D	Convolution	OpenCL	7769	676378	684147
Iter 125: InceptionV4/InceptionV4/Mixed_6g/Branch_0/Conv2d_0a_1x1/Conv2D	Convolution	CPU	21765	676461	698226
Iter 126: InceptionV4/InceptionV4/Mixed_6g/Branch_1/Conv2d_0b_1x7/Conv2D	Convolution	OpenCL	16701	684216	700917
Iter 127: InceptionV4/InceptionV4/Mixed_6g/Branch_2/Conv2d_0a_1x1/Conv2D	Convolution	CPU	11121	698370	709491
Iter 128: InceptionV4/InceptionV4/Mixed_6g/Branch_2/Conv2d_0b_7x1/Conv2D	Convolution	CPU	8139	709616	717755
Iter 129: InceptionV4/InceptionV4/Mixed_6g/Branch_1/Conv2d_0c_7x1/Conv2D	Convolution	OpenCL	20724	700984	721708
Iter 130: InceptionV4/InceptionV4/Mixed_6g/Branch_3/AvgPool_0a_3x3/AvgPool	Pooling	OpenCL	6393	721824	728217
Iter 131: InceptionV4/InceptionV4/Mixed_6g/Branch_2/Conv2d_0c_1x7/Conv2D	Convolution	CPU	11993	718024	730017
Iter 132: InceptionV4/InceptionV4/Mixed_6g/Branch_3/Conv2d_0b_1x1/Conv2D	Convolution	OpenCL	5777	728334	734111
Iter 133: InceptionV4/InceptionV4/Mixed_6g/Branch_2/Conv2d_0d_7x1/Conv2D	Convolution	CPU	10607	730123	740730
Iter 134: InceptionV4/InceptionV4/Mixed_6g/Branch_2/Conv2d_0e_1x7/Conv2D	Convolution	CPU	11429	740894	752323
Iter 135: InceptionV4/InceptionV4/Mixed_6g/concat	Concat	OpenCL	2182	752517	754699
Iter 136: InceptionV4/InceptionV4/Mixed_6h/Branch_1/Conv2d_0a_1x1/Conv2D	Convolution	OpenCL	8396	754760	763156
Iter 137: InceptionV4/InceptionV4/Mixed_6h/Branch_0/Conv2d_0a_1x1/Conv2D	Convolution	CPU	22389	754861	777250
Iter 138: InceptionV4/InceptionV4/Mixed_6h/Branch_1/Conv2d_0b_1x7/Conv2D	Convolution	OpenCL	15785	763206	778991
Iter 139: InceptionV4/InceptionV4/Mixed_6h/Branch_2/Conv2d_0a_1x1/Conv2D	Convolution	CPU	9497	777401	786898
Iter 140: InceptionV4/InceptionV4/Mixed_6h/Branch_2/Conv2d_0b_7x1/Conv2D	Convolution	CPU	7891	787044	794935
Iter 141: InceptionV4/InceptionV4/Mixed_6h/Branch_1/Conv2d_0c_7x1/Conv2D	Convolution	OpenCL	19999	779055	799054
Iter 142: InceptionV4/InceptionV4/Mixed_6h/Branch_3/AvgPool_0a_3x3/AvgPool	Pooling	OpenCL	6319	799172	805491
Iter 143: InceptionV4/InceptionV4/Mixed_6h/Branch_2/Conv2d_0c_1x7/Conv2D	Convolution	CPU	12078	795074	807152
Iter 144: InceptionV4/InceptionV4/Mixed_6h/Branch_3/Conv2d_0b_1x1/Conv2D	Convolution	OpenCL	5737	805612	811349
Iter 145: InceptionV4/InceptionV4/Mixed_6h/Branch_2/Conv2d_0d_7x1/Conv2D	Convolution	CPU	10546	807240	817786
Iter 146: InceptionV4/InceptionV4/Mixed_6h/Branch_2/Conv2d_0e_1x7/Conv2D	Convolution	CPU	11384	818048	829432
Iter 147: InceptionV4/InceptionV4/Mixed_6h/concat	Concat	OpenCL	2103	829658	831761
Iter 148: InceptionV4/InceptionV4/Mixed_7a/Branch_0/Conv2d_0a_1x1/Conv2D	Convolution	OpenCL	7703	831820	839523
Iter 149: InceptionV4/InceptionV4/Mixed_7a/Branch_0/Conv2d_1a_3x3/Conv2D	Convolution	OpenCL	4362	839574	843936
Iter 150: InceptionV4/InceptionV4/Mixed_7a/Branch_2/MaxPool_1a_3x3/MaxPool	Pooling	OpenCL	2375	844038	846413
Iter 151: InceptionV4/InceptionV4/Mixed_7a/Branch_1/Conv2d_0a_1x1/Conv2D	Convolution	CPU	18898	831910	850808
Iter 152: InceptionV4/InceptionV4/Mixed_7a/Branch_1/Conv2d_0b_1x7/Conv2D	Convolution	CPU	13271	850953	864224
Iter 153: InceptionV4/InceptionV4/Mixed_7a/Branch_1/Conv2d_0c_7x1/Conv2D	Convolution	CPU	17038	864471	881509
Iter 154: InceptionV4/InceptionV4/Mixed_7a/Branch_1/Conv2d_1a_3x3/Conv2D	Convolution	CPU	8334	881710	890044
Iter 155: InceptionV4/InceptionV4/Mixed_7a/concat	Concat	CPU	473	890261	890734
Iter 156: InceptionV4/InceptionV4/Mixed_7b/Branch_0/Conv2d_0a_1x1/Conv2D	Convolution	OpenCL	4133	890959	895092
Iter 157: InceptionV4/InceptionV4/Mixed_7b/Branch_2/Conv2d_0a_1x1/Conv2D	Convolution	CPU	4820	890784	895604
Iter 158: InceptionV4/InceptionV4/Mixed_7b/Branch_2/Conv2d_0b_3x1/Conv2D	Convolution	CPU	4786	895711	900497
Iter 159: InceptionV4/InceptionV4/Mixed_7b/Branch_1/Conv2d_0a_1x1/Conv2D	Convolution	OpenCL	5622	895233	900855
Iter 160: InceptionV4/InceptionV4/Mixed_7b/Branch_1/Conv2d_0b_1x3/Conv2D	Convolution	OpenCL	3869	900981	904850
Iter 161: InceptionV4/InceptionV4/Mixed_7b/Branch_2/Conv2d_0c_1x3/Conv2D	Convolution	CPU	6751	900623	907374
Iter 162: InceptionV4/InceptionV4/Mixed_7b/Branch_1/Conv2d_0c_3x1/Conv2D	Convolution	OpenCL	3521	904953	908474
Iter 163: InceptionV4/InceptionV4/Mixed_7b/Branch_1/concat	Concat	OpenCL	1252	908557	909809
Iter 164: InceptionV4/InceptionV4/Mixed_7b/Branch_2/Conv2d_0d_1x3/Conv2D	Convolution	CPU	4226	907497	911723
Iter 165: InceptionV4/InceptionV4/Mixed_7b/Branch_3/AvgPool_0a_3x3/AvgPool	Pooling	OpenCL	2865	909878	912743
Iter 166: InceptionV4/InceptionV4/Mixed_7b/Branch_2/Conv2d_0e_3x1/Conv2D	Convolution	CPU	3987	911863	915850
Iter 167: InceptionV4/InceptionV4/Mixed_7b/Branch_2/concat	Concat	CPU	90	915979	916069
Iter 168: InceptionV4/InceptionV4/Mixed_7b/Branch_3/Conv2d_0b_1x1/Conv2D	Convolution	OpenCL	3262	912829	916091
Iter 169: InceptionV4/InceptionV4/Mixed_7b/concat	Concat	CPU	389	916220	916609
Iter 170: InceptionV4/InceptionV4/Mixed_7c/Branch_0/Conv2d_0a_1x1/Conv2D	Convolution	CPU	3602	916657	920259
Iter 171: InceptionV4/InceptionV4/Mixed_7c/Branch_1/Conv2d_0a_1x1/Conv2D	Convolution	OpenCL	5515	916749	922264
Iter 172: InceptionV4/InceptionV4/Mixed_7c/Branch_2/Conv2d_0a_1x1/Conv2D	Convolution	CPU	5285	920391	925676
Iter 173: InceptionV4/InceptionV4/Mixed_7c/Branch_1/Conv2d_0b_1x3/Conv2D	Convolution	OpenCL	4168	922365	926533
Iter 174: InceptionV4/InceptionV4/Mixed_7c/Branch_1/Conv2d_0c_3x1/Conv2D	Convolution	OpenCL	3659	926643	930302
Iter 175: InceptionV4/InceptionV4/Mixed_7c/Branch_2/Conv2d_0b_3x1/Conv2D	Convolution	CPU	5028	925824	930852
Iter 176: InceptionV4/InceptionV4/Mixed_7c/Branch_1/concat	Concat	OpenCL	1263	930416	931679
Iter 177: InceptionV4/InceptionV4/Mixed_7c/Branch_3/AvgPool_0a_3x3/AvgPool	Pooling	OpenCL	2964	931759	934723
Iter 178: InceptionV4/InceptionV4/Mixed_7c/Branch_2/Conv2d_0c_1x3/Conv2D	Convolution	CPU	6964	930934	937898
Iter 179: InceptionV4/InceptionV4/Mixed_7c/Branch_3/Conv2d_0b_1x1/Conv2D	Convolution	OpenCL	3246	934829	938075
Iter 180: InceptionV4/InceptionV4/Mixed_7c/Branch_2/Conv2d_0d_1x3/Conv2D	Convolution	CPU	3418	938038	941456
Iter 181: InceptionV4/InceptionV4/Mixed_7c/Branch_2/Conv2d_0e_3x1/Conv2D	Convolution	CPU	3412	941575	944987
Iter 182: InceptionV4/InceptionV4/Mixed_7c/Branch_2/concat	Concat	CPU	209	945110	945319
Iter 183: InceptionV4/InceptionV4/Mixed_7c/concat	Concat	CPU	357	945364	945721
Iter 184: InceptionV4/InceptionV4/Mixed_7d/Branch_0/Conv2d_0a_1x1/Conv2D	Convolution	CPU	3692	945769	949461
Iter 185: InceptionV4/InceptionV4/Mixed_7d/Branch_1/Conv2d_0a_1x1/Conv2D	Convolution	OpenCL	5523	945879	951402
Iter 186: InceptionV4/InceptionV4/Mixed_7d/Branch_2/Conv2d_0a_1x1/Conv2D	Convolution	CPU	5312	949593	954905
Iter 187: InceptionV4/InceptionV4/Mixed_7d/Branch_1/Conv2d_0b_1x3/Conv2D	Convolution	OpenCL	4683	951511	956194
Iter 188: InceptionV4/InceptionV4/Mixed_7d/Branch_1/Conv2d_0c_3x1/Conv2D	Convolution	OpenCL	3582	956300	959882
Iter 189: InceptionV4/InceptionV4/Mixed_7d/Branch_2/Conv2d_0b_3x1/Conv2D	Convolution	CPU	5124	955050	960174
Iter 190: InceptionV4/InceptionV4/Mixed_7d/Branch_1/concat	Concat	OpenCL	1345	959984	961329
Iter 191: InceptionV4/InceptionV4/Mixed_7d/Branch_3/AvgPool_0a_3x3/AvgPool	Pooling	OpenCL	3052	961411	964463
Iter 192: InceptionV4/InceptionV4/Mixed_7d/Branch_2/Conv2d_0c_1x3/Conv2D	Convolution	CPU	7150	960263	967413
Iter 193: InceptionV4/InceptionV4/Mixed_7d/Branch_3/Conv2d_0b_1x1/Conv2D	Convolution	OpenCL	3452	964568	968020
Iter 194: InceptionV4/InceptionV4/Mixed_7d/Branch_2/Conv2d_0d_1x3/Conv2D	Convolution	CPU	3429	967505	970934
Iter 195: InceptionV4/InceptionV4/Mixed_7d/Branch_2/Conv2d_0e_3x1/Conv2D	Convolution	CPU	3325	971042	974367
Iter 196: InceptionV4/InceptionV4/Mixed_7d/Branch_2/concat	Concat	CPU	73	974499	974572
Iter 197: InceptionV4/InceptionV4/Mixed_7d/concat	Concat	CPU	335	974619	974954
Iter 198: InceptionV4/Logits/AvgPool_1a/AvgPool	Pooling	CPU	145	975018	975163
Iter 199: InceptionV4/Logits/PreLogitsFlatten/flatten/Shape	Shape	CPU	1	975227	975228
Iter 200: InceptionV4/Logits/PreLogitsFlatten/flatten/strided_slice	StridedSlice	CPU	1	975272	975273
Iter 201: InceptionV4/Logits/PreLogitsFlatten/flatten/Reshape/shape	Pack	CPU	0	975314	975314
Iter 202: InceptionV4/Logits/AvgPool_1a/AvgPool___tr4InceptionV4/Logits/PreLogitsFlatten/flatten/Reshape	ConvertTensor	CPU	5	975362	975367
Iter 203: InceptionV4/Logits/PreLogitsFlatten/flatten/Reshape	Reshape	CPU	4	975418	975422
Iter 204: InceptionV4/Logits/Logits/MatMul	MatMul	CPU	15289	975475	990764
Iter 205: InceptionV4/Logits/Logits/BiasAdd	BinaryOp	CPU	31	990880	990911
Iter 206: InceptionV4/Logits/Predictions	Softmax	CPU	19	990964	990983
Iter 0: InceptionV4/InceptionV4/Conv2d_1a_3x3/Conv2D	Convolution	CPU	4077	392	4469
Iter 1: InceptionV4/InceptionV4/Conv2d_2a_3x3/Conv2D	Convolution	CPU	11178	4725	15903
Iter 2: InceptionV4/InceptionV4/Conv2d_2b_3x3/Conv2D	Convolution	CPU	21485	16112	37597
Iter 3: InceptionV4/InceptionV4/Mixed_3a/Branch_0/MaxPool_0a_3x3/MaxPool	Pooling	CPU	1763	37813	39576
Iter 4: InceptionV4/InceptionV4/Mixed_3a/Branch_1/Conv2d_0a_3x3/Conv2D	Convolution	CPU	27530	39706	67236
Iter 5: InceptionV4/InceptionV4/Mixed_3a/concat	Concat	CPU	1949	67449	69398
Iter 6: InceptionV4/InceptionV4/Mixed_4a/Branch_1/Conv2d_0a_1x1/Conv2D	Convolution	CPU	4735	69479	74214
Iter 7: InceptionV4/InceptionV4/Mixed_4a/Branch_0/Conv2d_0a_1x1/Conv2D	Convolution	OpenCL	13727	69553	83280
Iter 8: InceptionV4/InceptionV4/Mixed_4a/Branch_1/Conv2d_0b_1x7/Conv2D	Convolution	CPU	14596	74341	88937
Iter 9: InceptionV4/InceptionV4/Mixed_4a/Branch_1/Conv2d_0c_7x1/Conv2D	Convolution	CPU	15841	89117	104958
Iter 10: InceptionV4/InceptionV4/Mixed_4a/Branch_0/Conv2d_1a_3x3/Conv2D	Convolution	OpenCL	29292	83375	112667
Iter 11: InceptionV4/InceptionV4/Mixed_4a/Branch_1/Conv2d_1a_3x3/Conv2D	Convolution	CPU	15087	105287	120374
Iter 12: InceptionV4/InceptionV4/Mixed_4a/concat	Concat	CPU	2826	120618	123444
Iter 13: InceptionV4/InceptionV4/Mixed_5a/Branch_0/Conv2d_1a_3x3/Conv2D	Convolution	CPU	37173	123517	160690
Iter 14: InceptionV4/InceptionV4/Mixed_5a/Branch_1/MaxPool_1a_3x3/MaxPool	Pooling	CPU	1305	161021	162326
Iter 15: InceptionV4/InceptionV4/Mixed_5a/concat	Concat	CPU	1093	162438	163531
Iter 16: InceptionV4/InceptionV4/Mixed_5b/Branch_0/Conv2d_0a_1x1/Conv2D	Convolution	CPU	3923	163734	167657
Iter 17: InceptionV4/InceptionV4/Mixed_5b/Branch_1/Conv2d_0a_1x1/Conv2D	Convolution	OpenCL	5965	163651	169616
Iter 18: InceptionV4/InceptionV4/Mixed_5b/Branch_2/Conv2d_0a_1x1/Conv2D	Convolution	CPU	2768	167795	170563
Iter 19: InceptionV4/InceptionV4/Mixed_5b/Branch_2/Conv2d_0b_3x3/Conv2D	Convolution	CPU	5342	170703	176045
Iter 20: InceptionV4/InceptionV4/Mixed_5b/Branch_1/Conv2d_0b_3x3/Conv2D	Convolution	OpenCL	8763	169713	178476
Iter 21: InceptionV4/InceptionV4/Mixed_5b/Branch_2/Conv2d_0c_3x3/Conv2D	Convolution	CPU	6573	176255	182828
Iter 22: InceptionV4/InceptionV4/Mixed_5b/Branch_3/AvgPool_0a_3x3/AvgPool	Pooling	CPU	1894	183109	185003
Iter 23: InceptionV4/InceptionV4/Mixed_5b/Branch_3/Conv2d_0b_1x1/Conv2D	Convolution	CPU	3800	185273	189073
Iter 24: InceptionV4/InceptionV4/Mixed_5b/concat	Concat	CPU	1401	189211	190612
Iter 25: InceptionV4/InceptionV4/Mixed_5c/Branch_0/Conv2d_0a_1x1/Conv2D	Convolution	CPU	4008	190682	194690
Iter 26: InceptionV4/InceptionV4/Mixed_5c/Branch_3/AvgPool_0a_3x3/AvgPool	Pooling	OpenCL	6003	190781	196784
Iter 27: InceptionV4/InceptionV4/Mixed_5c/Branch_1/Conv2d_0a_1x1/Conv2D	Convolution	CPU	2965	194861	197826
Iter 28: InceptionV4/InceptionV4/Mixed_5c/Branch_1/Conv2d_0b_3x3/Conv2D	Convolution	CPU	4026	197925	201951
Iter 29: InceptionV4/InceptionV4/Mixed_5c/Branch_3/Conv2d_0b_1x1/Conv2D	Convolution	OpenCL	6291	196880	203171
Iter 30: InceptionV4/InceptionV4/Mixed_5c/Branch_2/Conv2d_0a_1x1/Conv2D	Convolution	CPU	2748	202110	204858
Iter 31: InceptionV4/InceptionV4/Mixed_5c/Branch_2/Conv2d_0b_3x3/Conv2D	Convolution	CPU	3825	204968	208793
Iter 32: InceptionV4/InceptionV4/Mixed_5c/Branch_2/Conv2d_0c_3x3/Conv2D	Convolution	CPU	5629	208948	214577
Iter 33: InceptionV4/InceptionV4/Mixed_5c/concat	Concat	CPU	1457	214766	216223
Iter 34: InceptionV4/InceptionV4/Mixed_5d/Branch_0/Conv2d_0a_1x1/Conv2D	Convolution	CPU	4026	216278	220304
Iter 35: InceptionV4/InceptionV4/Mixed_5d/Branch_3/AvgPool_0a_3x3/AvgPool	Pooling	OpenCL	6053	216421	222474
Iter 36: InceptionV4/InceptionV4/Mixed_5d/Branch_1/Conv2d_0a_1x1/Conv2D	Convolution	CPU	2824	220470	223294
Iter 37: InceptionV4/InceptionV4/Mixed_5d/Branch_1/Conv2d_0b_3x3/Conv2D	Convolution	CPU	3973	223404	227377
Iter 38: InceptionV4/InceptionV4/Mixed_5d/Branch_3/Conv2d_0b_1x1/Conv2D	Convolution	OpenCL	6955	222647	229602
Iter 39: InceptionV4/InceptionV4/Mixed_5d/Branch_2/Conv2d_0a_1x1/Conv2D	Convolution	CPU	2791	227528	230319
Iter 40: InceptionV4/InceptionV4/Mixed_5d/Branch_2/Conv2d_0b_3x3/Conv2D	Convolution	CPU	3784	230429	234213
Iter 41: InceptionV4/InceptionV4/Mixed_5d/Branch_2/Conv2d_0c_3x3/Conv2D	Convolution	CPU	5635	234384	240019
Iter 42: InceptionV4/InceptionV4/Mixed_5d/concat	Concat	CPU	1490	240332	241822
Iter 43: InceptionV4/InceptionV4/Mixed_5e/Branch_0/Conv2d_0a_1x1/Conv2D	Convolution	CPU	4054	241875	245929
Iter 44: InceptionV4/InceptionV4/Mixed_5e/Branch_3/AvgPool_0a_3x3/AvgPool	Pooling	OpenCL	5948	242051	247999
Iter 45: InceptionV4/InceptionV4/Mixed_5e/Branch_1/Conv2d_0a_1x1/Conv2D	Convolution	CPU	2888	246084	248972
Iter 46: InceptionV4/InceptionV4/Mixed_5e/Branch_1/Conv2d_0b_3x3/Conv2D	Convolution	CPU	3940	249069	253009
Iter 47: InceptionV4/InceptionV4/Mixed_5e/Branch_3/Conv2d_0b_1x1/Conv2D	Convolution	OpenCL	6280	248125	254405
Iter 48: InceptionV4/InceptionV4/Mixed_5e/Branch_2/Conv2d_0a_1x1/Conv2D	Convolution	CPU	2859	253157	256016
Iter 49: InceptionV4/InceptionV4/Mixed_5e/Branch_2/Conv2d_0b_3x3/Conv2D	Convolution	CPU	3714	256127	259841
Iter 50: InceptionV4/InceptionV4/Mixed_5e/Branch_2/Conv2d_0c_3x3/Conv2D	Convolution	CPU	5580	260120	265700
Iter 51: InceptionV4/InceptionV4/Mixed_5e/concat	Concat	CPU	1432	265845	267277
Iter 52: InceptionV4/InceptionV4/Mixed_6a/Branch_1/Conv2d_0a_1x1/Conv2D	Convolution	CPU	7480	267335	274815
Iter 53: InceptionV4/InceptionV4/Mixed_6a/Branch_1/Conv2d_0b_3x3/Conv2D	Convolution	CPU	26493	274966	301459
Iter 54: InceptionV4/InceptionV4/Mixed_6a/Branch_1/Conv2d_1a_3x3/Conv2D	Convolution	CPU	17117	301620	318737
Iter 55: InceptionV4/InceptionV4/Mixed_6a/Branch_2/MaxPool_1a_3x3/MaxPool	Pooling	CPU	784	318890	319674
Iter 56: InceptionV4/InceptionV4/Mixed_6a/Branch_0/Conv2d_1a_3x3/Conv2D	Convolution	OpenCL	72861	267477	340338
Iter 57: InceptionV4/InceptionV4/Mixed_6a/concat	Concat	CPU	21550	319802	341352
Iter 58: InceptionV4/InceptionV4/Mixed_6b/Branch_1/Conv2d_0a_1x1/Conv2D	Convolution	OpenCL	9344	341575	350919
Iter 59: InceptionV4/InceptionV4/Mixed_6b/Branch_0/Conv2d_0a_1x1/Conv2D	Convolution	CPU	13024	341400	354424
Iter 60: InceptionV4/InceptionV4/Mixed_6b/Branch_2/Conv2d_0a_1x1/Conv2D	Convolution	CPU	6812	354521	361333
Iter 61: InceptionV4/InceptionV4/Mixed_6b/Branch_1/Conv2d_0b_1x7/Conv2D	Convolution	OpenCL	15813	351139	366952
Iter 62: InceptionV4/InceptionV4/Mixed_6b/Branch_2/Conv2d_0b_7x1/Conv2D	Convolution	CPU	8032	361477	369509
Iter 63: InceptionV4/InceptionV4/Mixed_6b/Branch_2/Conv2d_0c_1x7/Conv2D	Convolution	CPU	8840	369615	378455
Iter 64: InceptionV4/InceptionV4/Mixed_6b/Branch_1/Conv2d_0c_7x1/Conv2D	Convolution	OpenCL	19503	367150	386653
Iter 65: InceptionV4/InceptionV4/Mixed_6b/Branch_2/Conv2d_0d_7x1/Conv2D	Convolution	CPU	11714	378592	390306
Iter 66: InceptionV4/InceptionV4/Mixed_6b/Branch_3/AvgPool_0a_3x3/AvgPool	Pooling	OpenCL	7551	386934	394485
Iter 67: InceptionV4/InceptionV4/Mixed_6b/Branch_3/Conv2d_0b_1x1/Conv2D	Convolution	OpenCL	5682	394697	400379
Iter 68: InceptionV4/InceptionV4/Mixed_6b/Branch_2/Conv2d_0e_1x7/Conv2D	Convolution	CPU	14020	390511	404531
Iter 69: InceptionV4/InceptionV4/Mixed_6b/concat	Concat	CPU	1020	404723	405743
Iter 70: InceptionV4/InceptionV4/Mixed_6c/Branch_1/Conv2d_0a_1x1/Conv2D	Convolution	OpenCL	9355	405965	415320
Iter 71: InceptionV4/InceptionV4/Mixed_6c/Branch_0/Conv2d_0a_1x1/Conv2D	Convolution	CPU	13017	405834	418851
Iter 72: InceptionV4/InceptionV4/Mixed_6c/Branch_2/Conv2d_0a_1x1/Conv2D	Convolution	CPU	6788	418957	425745
Iter 73: InceptionV4/InceptionV4/Mixed_6c/Branch_1/Conv2d_0b_1x7/Conv2D	Convolution	OpenCL	15850	415441	431291
Iter 74: InceptionV4/InceptionV4/Mixed_6c/Branch_2/Conv2d_0b_7x1/Conv2D	Convolution	CPU	7941	425886	433827
Iter 75: InceptionV4/InceptionV4/Mixed_6c/Branch_2/Conv2d_0c_1x7/Conv2D	Convolution	CPU	8787	433965	442752
Iter 76: InceptionV4/InceptionV4/Mixed_6c/Branch_1/Conv2d_0c_7x1/Conv2D	Convolution	OpenCL	19556	431398	450954
Iter 77: InceptionV4/InceptionV4/Mixed_6c/Branch_2/Conv2d_0d_7x1/Conv2D	Convolution	CPU	11529	442892	454421
Iter 78: InceptionV4/InceptionV4/Mixed_6c/Branch_3/AvgPool_0a_3x3/AvgPool	Pooling	OpenCL	7342	451082	458424
Iter 79: InceptionV4/InceptionV4/Mixed_6c/Branch_3/Conv2d_0b_1x1/Conv2D	Convolution	OpenCL	5595	458534	464129
Iter 80: InceptionV4/InceptionV4/Mixed_6c/Branch_2/Conv2d_0e_1x7/Conv2D	Convolution	CPU	13767	454608	468375
Iter 81: InceptionV4/InceptionV4/Mixed_6c/concat	Concat	CPU	930	468590	469520
Iter 82: InceptionV4/InceptionV4/Mixed_6d/Branch_1/Conv2d_0a_1x1/Conv2D	Convolution	OpenCL	9259	469703	478962
Iter 83: InceptionV4/InceptionV4/Mixed_6d/Branch_0/Conv2d_0a_1x1/Conv2D	Convolution	CPU	12982	469591	482573
Iter 84: InceptionV4/InceptionV4/Mixed_6d/Branch_2/Conv2d_0a_1x1/Conv2D	Convolution	CPU	6662	482690	489352
Iter 85: InceptionV4/InceptionV4/Mixed_6d/Branch_1/Conv2d_0b_1x7/Conv2D	Convolution	OpenCL	15745	479088	494833
Iter 86: InceptionV4/InceptionV4/Mixed_6d/Branch_2/Conv2d_0b_7x1/Conv2D	Convolution	CPU	8095	489485	497580
Iter 87: InceptionV4/InceptionV4/Mixed_6d/Branch_2/Conv2d_0c_1x7/Conv2D	Convolution	CPU	8793	497688	506481
Iter 88: InceptionV4/InceptionV4/Mixed_6d/Branch_1/Conv2d_0c_7x1/Conv2D	Convolution	OpenCL	19718	494968	514686
Iter 89: InceptionV4/InceptionV4/Mixed_6d/Branch_2/Conv2d_0d_7x1/Conv2D	Convolution	CPU	11608	506606	518214
Iter 90: InceptionV4/InceptionV4/Mixed_6d/Branch_3/AvgPool_0a_3x3/AvgPool	Pooling	OpenCL	7363	514803	522166
Iter 91: InceptionV4/InceptionV4/Mixed_6d/Branch_3/Conv2d_0b_1x1/Conv2D	Convolution	OpenCL	5675	522301	527976
Iter 92: InceptionV4/InceptionV4/Mixed_6d/Branch_2/Conv2d_0e_1x7/Conv2D	Convolution	CPU	13756	518440	532196
Iter 93: InceptionV4/Logits/PreLogitsFlatten/flatten/strided_slice/stack	Const	CPU	1	532414	532415
Iter 94: InceptionV4/Logits/PreLogitsFlatten/flatten/strided_slice/stack_1	Const	CPU	1	532493	532494
Iter 95: InceptionV4/Logits/PreLogitsFlatten/flatten/strided_slice/stack_2	Const	CPU	0	532573	532573
Iter 96: InceptionV4/Logits/PreLogitsFlatten/flatten/Reshape/shape/1	Const	CPU	1	532669	532670
Iter 97: InceptionV4/Logits/Logits/weights	Const	CPU	0	532729	532729
Iter 98: InceptionV4/Logits/Logits/biases	Const	CPU	1	532786	532787
Iter 99: InceptionV4/InceptionV4/Mixed_6d/concat	Concat	OpenCL	1855	532635	534490
Iter 100: InceptionV4/InceptionV4/Mixed_6e/Branch_1/Conv2d_0a_1x1/Conv2D	Convolution	OpenCL	7768	534570	542338
Iter 101: InceptionV4/InceptionV4/Mixed_6e/Branch_0/Conv2d_0a_1x1/Conv2D	Convolution	CPU	21746	534648	556394
Iter 102: InceptionV4/InceptionV4/Mixed_6e/Branch_1/Conv2d_0b_1x7/Conv2D	Convolution	OpenCL	15485	542391	557876
Iter 103: InceptionV4/InceptionV4/Mixed_6e/Branch_2/Conv2d_0a_1x1/Conv2D	Convolution	CPU	8763	556554	565317
Iter 104: InceptionV4/InceptionV4/Mixed_6e/Branch_2/Conv2d_0b_7x1/Conv2D	Convolution	CPU	7811	565451	573262
Iter 105: InceptionV4/InceptionV4/Mixed_6e/Branch_1/Conv2d_0c_7x1/Conv2D	Convolution	OpenCL	20697	557956	578653
Iter 106: InceptionV4/InceptionV4/Mixed_6e/Branch_2/Conv2d_0c_1x7/Conv2D	Convolution	CPU	11220	573403	584623
Iter 107: InceptionV4/InceptionV4/Mixed_6e/Branch_3/AvgPool_0a_3x3/AvgPool	Pooling	OpenCL	6169	578772	584941
Iter 108: InceptionV4/InceptionV4/Mixed_6e/Branch_3/Conv2d_0b_1x1/Conv2D	Convolution	OpenCL	5634	585021	590655
Iter 109: InceptionV4/InceptionV4/Mixed_6e/Branch_2/Conv2d_0d_7x1/Conv2D	Convolution	CPU	10724	584756	595480
Iter 110: InceptionV4/InceptionV4/Mixed_6e/Branch_2/Conv2d_0e_1x7/Conv2D	Convolution	CPU	11298	595617	606915
Iter 111: InceptionV4/InceptionV4/Mixed_6e/concat	Concat	CPU	965	607083	608048
Iter 112: InceptionV4/InceptionV4/Mixed_6f/Branch_1/Conv2d_0a_1x1/Conv2D	Convolution	OpenCL	9074	608208	617282
Iter 113: InceptionV4/InceptionV4/Mixed_6f/Branch_0/Conv2d_0a_1x1/Conv2D	Convolution	CPU	13015	608124	621139
Iter 114: InceptionV4/InceptionV4/Mixed_6f/Branch_2/Conv2d_0a_1x1/Conv2D	Convolution	CPU	6716	621235	627951
Iter 115: InceptionV4/InceptionV4/Mixed_6f/Branch_1/Conv2d_0b_1x7/Conv2D	Convolution	OpenCL	15644	617390	633034
Iter 116: InceptionV4/InceptionV4/Mixed_6f/Branch_2/Conv2d_0b_7x1/Conv2D	Convolution	CPU	7994	628097	636091
Iter 117: InceptionV4/InceptionV4/Mixed_6f/Branch_2/Conv2d_0c_1x7/Conv2D	Convolution	CPU	8851	636205	645056
Iter 118: InceptionV4/InceptionV4/Mixed_6f/Branch_1/Conv2d_0c_7x1/Conv2D	Convolution	OpenCL	20417	633155	653572
Iter 119: InceptionV4/InceptionV4/Mixed_6f/Branch_2/Conv2d_0d_7x1/Conv2D	Convolution	CPU	11761	645234	656995
Iter 120: InceptionV4/InceptionV4/Mixed_6f/Branch_3/AvgPool_0a_3x3/AvgPool	Pooling	OpenCL	7402	653692	661094
Iter 121: InceptionV4/InceptionV4/Mixed_6f/Branch_3/Conv2d_0b_1x1/Conv2D	Convolution	OpenCL	5614	661224	666838
Iter 122: InceptionV4/InceptionV4/Mixed_6f/Branch_2/Conv2d_0e_1x7/Conv2D	Convolution	CPU	13808	657183	670991
Iter 123: InceptionV4/InceptionV4/Mixed_6f/concat	Concat	OpenCL	1875	671284	673159
Iter 124: InceptionV4/InceptionV4/Mixed_6g/Branch_1/Conv2d_0a_1x1/Conv2D	Convolution	OpenCL	7649	673219	680868
Iter 125: InceptionV4/InceptionV4/Mixed_6g/Branch_0/Conv2d_0a_1x1/Conv2D	Convolution	CPU	21397	673318	694715
Iter 126: InceptionV4/InceptionV4/Mixed_6g/Branch_1/Conv2d_0b_1x7/Conv2D	Convolution	OpenCL	16479	680921	697400
Iter 127: InceptionV4/InceptionV4/Mixed_6g/Branch_2/Conv2d_0a_1x1/Conv2D	Convolution	CPU	9130	694878	704008
Iter 128: InceptionV4/InceptionV4/Mixed_6g/Branch_2/Conv2d_0b_7x1/Conv2D	Convolution	CPU	7898	704149	712047
Iter 129: InceptionV4/InceptionV4/Mixed_6g/Branch_1/Conv2d_0c_7x1/Conv2D	Convolution	OpenCL	19877	697533	717410
Iter 130: InceptionV4/InceptionV4/Mixed_6g/Branch_2/Conv2d_0c_1x7/Conv2D	Convolution	CPU	11399	712259	723658
Iter 131: InceptionV4/InceptionV4/Mixed_6g/Branch_3/AvgPool_0a_3x3/AvgPool	Pooling	OpenCL	6255	717532	723787
Iter 132: InceptionV4/InceptionV4/Mixed_6g/Branch_3/Conv2d_0b_1x1/Conv2D	Convolution	OpenCL	5725	723880	729605
Iter 133: InceptionV4/InceptionV4/Mixed_6g/Branch_2/Conv2d_0d_7x1/Conv2D	Convolution	CPU	10736	723783	734519
Iter 134: InceptionV4/InceptionV4/Mixed_6g/Branch_2/Conv2d_0e_1x7/Conv2D	Convolution	CPU	11547	734751	746298
Iter 135: InceptionV4/InceptionV4/Mixed_6g/concat	Concat	OpenCL	2118	746550	748668
Iter 136: InceptionV4/InceptionV4/Mixed_6h/Branch_1/Conv2d_0a_1x1/Conv2D	Convolution	OpenCL	8160	748729	756889
Iter 137: InceptionV4/InceptionV4/Mixed_6h/Branch_0/Conv2d_0a_1x1/Conv2D	Convolution	CPU	22006	748826	770832
Iter 138: InceptionV4/InceptionV4/Mixed_6h/Branch_1/Conv2d_0b_1x7/Conv2D	Convolution	OpenCL	16405	756942	773347
Iter 139: InceptionV4/InceptionV4/Mixed_6h/Branch_2/Conv2d_0a_1x1/Conv2D	Convolution	CPU	9166	770992	780158
Iter 140: InceptionV4/InceptionV4/Mixed_6h/Branch_2/Conv2d_0b_7x1/Conv2D	Convolution	CPU	7890	780302	788192
Iter 141: InceptionV4/InceptionV4/Mixed_6h/Branch_1/Conv2d_0c_7x1/Conv2D	Convolution	OpenCL	19858	773491	793349
Iter 142: InceptionV4/InceptionV4/Mixed_6h/Branch_3/AvgPool_0a_3x3/AvgPool	Pooling	OpenCL	6238	793473	799711
Iter 143: InceptionV4/InceptionV4/Mixed_6h/Branch_2/Conv2d_0c_1x7/Conv2D	Convolution	CPU	11526	788332	799858
Iter 144: InceptionV4/InceptionV4/Mixed_6h/Branch_3/Conv2d_0b_1x1/Conv2D	Convolution	OpenCL	5671	799846	805517
Iter 145: InceptionV4/InceptionV4/Mixed_6h/Branch_2/Conv2d_0d_7x1/Conv2D	Convolution	CPU	11908	799944	811852
Iter 146: InceptionV4/InceptionV4/Mixed_6h/Branch_2/Conv2d_0e_1x7/Conv2D	Convolution	CPU	12691	812017	824708
Iter 147: InceptionV4/InceptionV4/Mixed_6h/concat	Concat	OpenCL	2020	824904	826924
Iter 148: InceptionV4/InceptionV4/Mixed_7a/Branch_0/Conv2d_0a_1x1/Conv2D	Convolution	OpenCL	7637	826981	834618
Iter 149: InceptionV4/InceptionV4/Mixed_7a/Branch_0/Conv2d_1a_3x3/Conv2D	Convolution	OpenCL	4282	834673	838955
Iter 150: InceptionV4/InceptionV4/Mixed_7a/Branch_2/MaxPool_1a_3x3/MaxPool	Pooling	OpenCL	2304	839070	841374
Iter 151: InceptionV4/InceptionV4/Mixed_7a/Branch_1/Conv2d_0a_1x1/Conv2D	Convolution	CPU	18812	827069	845881
Iter 152: InceptionV4/InceptionV4/Mixed_7a/Branch_1/Conv2d_0b_1x7/Conv2D	Convolution	CPU	13244	846083	859327
Iter 153: InceptionV4/InceptionV4/Mixed_7a/Branch_1/Conv2d_0c_7x1/Conv2D	Convolution	CPU	17182	859576	876758
Iter 154: InceptionV4/InceptionV4/Mixed_7a/Branch_1/Conv2d_1a_3x3/Conv2D	Convolution	CPU	8319	877016	885335
Iter 155: InceptionV4/InceptionV4/Mixed_7a/concat	Concat	CPU	465	885483	885948
Iter 156: InceptionV4/InceptionV4/Mixed_7b/Branch_0/Conv2d_0a_1x1/Conv2D	Convolution	OpenCL	3807	886115	889922
Iter 157: InceptionV4/InceptionV4/Mixed_7b/Branch_2/Conv2d_0a_1x1/Conv2D	Convolution	CPU	4932	886010	890942
Iter 158: InceptionV4/InceptionV4/Mixed_7b/Branch_1/Conv2d_0a_1x1/Conv2D	Convolution	OpenCL	5496	890038	895534
Iter 159: InceptionV4/InceptionV4/Mixed_7b/Branch_2/Conv2d_0b_3x1/Conv2D	Convolution	CPU	5033	891061	896094
Iter 160: InceptionV4/InceptionV4/Mixed_7b/Branch_1/Conv2d_0b_1x3/Conv2D	Convolution	OpenCL	4000	895637	899637
Iter 161: InceptionV4/InceptionV4/Mixed_7b/Branch_2/Conv2d_0c_1x3/Conv2D	Convolution	CPU	6782	896211	902993
Iter 162: InceptionV4/InceptionV4/Mixed_7b/Branch_1/Conv2d_0c_3x1/Conv2D	Convolution	OpenCL	3570	899794	903364
Iter 163: InceptionV4/InceptionV4/Mixed_7b/Branch_1/concat	Concat	OpenCL	1471	903447	904918
Iter 164: InceptionV4/InceptionV4/Mixed_7b/Branch_2/Conv2d_0d_1x3/Conv2D	Convolution	CPU	4208	903088	907296
Iter 165: InceptionV4/InceptionV4/Mixed_7b/Branch_3/AvgPool_0a_3x3/AvgPool	Pooling	OpenCL	2906	905028	907934
Iter 166: InceptionV4/InceptionV4/Mixed_7b/Branch_2/Conv2d_0e_3x1/Conv2D	Convolution	CPU	3749	907445	911194
Iter 167: InceptionV4/InceptionV4/Mixed_7b/Branch_2/concat	Concat	CPU	86	911316	911402
Iter 168: InceptionV4/InceptionV4/Mixed_7b/Branch_3/Conv2d_0b_1x1/Conv2D	Convolution	OpenCL	3352	908050	911402
Iter 169: InceptionV4/InceptionV4/Mixed_7b/concat	Concat	CPU	364	911458	911822
Iter 170: InceptionV4/InceptionV4/Mixed_7c/Branch_0/Conv2d_0a_1x1/Conv2D	Convolution	CPU	3556	911870	915426
Iter 171: InceptionV4/InceptionV4/Mixed_7c/Branch_1/Conv2d_0a_1x1/Conv2D	Convolution	OpenCL	5449	912075	917524
Iter 172: InceptionV4/InceptionV4/Mixed_7c/Branch_2/Conv2d_0a_1x1/Conv2D	Convolution	CPU	5275	915542	920817
Iter 173: InceptionV4/InceptionV4/Mixed_7c/Branch_1/Conv2d_0b_1x3/Conv2D	Convolution	OpenCL	4121	917622	921743
Iter 174: InceptionV4/InceptionV4/Mixed_7c/Branch_1/Conv2d_0c_3x1/Conv2D	Convolution	OpenCL	3526	921855	925381
Iter 175: InceptionV4/InceptionV4/Mixed_7c/Branch_2/Conv2d_0b_3x1/Conv2D	Convolution	CPU	5021	920963	925984
Iter 176: InceptionV4/InceptionV4/Mixed_7c/Branch_1/concat	Concat	OpenCL	1344	925473	926817
Iter 177: InceptionV4/InceptionV4/Mixed_7c/Branch_3/AvgPool_0a_3x3/AvgPool	Pooling	OpenCL	2872	926914	929786
Iter 178: InceptionV4/InceptionV4/Mixed_7c/Branch_2/Conv2d_0c_1x3/Conv2D	Convolution	CPU	6967	926063	933030
Iter 179: InceptionV4/InceptionV4/Mixed_7c/Branch_3/Conv2d_0b_1x1/Conv2D	Convolution	OpenCL	3240	929913	933153
Iter 180: InceptionV4/InceptionV4/Mixed_7c/Branch_2/Conv2d_0d_1x3/Conv2D	Convolution	CPU	3396	933122	936518
Iter 181: InceptionV4/InceptionV4/Mixed_7c/Branch_2/Conv2d_0e_3x1/Conv2D	Convolution	CPU	3368	936642	940010
Iter 182: InceptionV4/InceptionV4/Mixed_7c/Branch_2/concat	Concat	CPU	125	940136	940261
Iter 183: InceptionV4/InceptionV4/Mixed_7c/concat	Concat	CPU	337	940332	940669
Iter 184: InceptionV4/InceptionV4/Mixed_7d/Branch_0/Conv2d_0a_1x1/Conv2D	Convolution	CPU	3458	940718	944176
Iter 185: InceptionV4/InceptionV4/Mixed_7d/Branch_1/Conv2d_0a_1x1/Conv2D	Convolution	OpenCL	5264	940901	946165
Iter 186: InceptionV4/InceptionV4/Mixed_7d/Branch_2/Conv2d_0a_1x1/Conv2D	Convolution	CPU	5177	944312	949489
Iter 187: InceptionV4/InceptionV4/Mixed_7d/Branch_1/Conv2d_0b_1x3/Conv2D	Convolution	OpenCL	4663	946272	950935
Iter 188: InceptionV4/InceptionV4/Mixed_7d/Branch_1/Conv2d_0c_3x1/Conv2D	Convolution	OpenCL	3585	951038	954623
Iter 189: InceptionV4/InceptionV4/Mixed_7d/Branch_2/Conv2d_0b_3x1/Conv2D	Convolution	CPU	5059	949636	954695
Iter 190: InceptionV4/InceptionV4/Mixed_7d/Branch_1/concat	Concat	OpenCL	1346	954729	956075
Iter 191: InceptionV4/InceptionV4/Mixed_7d/Branch_3/AvgPool_0a_3x3/AvgPool	Pooling	OpenCL	3003	956195	959198
Iter 192: InceptionV4/InceptionV4/Mixed_7d/Branch_2/Conv2d_0c_1x3/Conv2D	Convolution	CPU	7153	954802	961955
Iter 193: InceptionV4/InceptionV4/Mixed_7d/Branch_3/Conv2d_0b_1x1/Conv2D	Convolution	OpenCL	3453	959328	962781
Iter 194: InceptionV4/InceptionV4/Mixed_7d/Branch_2/Conv2d_0d_1x3/Conv2D	Convolution	CPU	3481	962045	965526
Iter 195: InceptionV4/InceptionV4/Mixed_7d/Branch_2/Conv2d_0e_3x1/Conv2D	Convolution	CPU	3351	965624	968975
Iter 196: InceptionV4/InceptionV4/Mixed_7d/Branch_2/concat	Concat	CPU	76	969102	969178
Iter 197: InceptionV4/InceptionV4/Mixed_7d/concat	Concat	CPU	343	969220	969563
Iter 198: InceptionV4/Logits/AvgPool_1a/AvgPool	Pooling	CPU	162	969608	969770
Iter 199: InceptionV4/Logits/PreLogitsFlatten/flatten/Shape	Shape	CPU	1	969832	969833
Iter 200: InceptionV4/Logits/PreLogitsFlatten/flatten/strided_slice	StridedSlice	CPU	0	969870	969870
Iter 201: InceptionV4/Logits/PreLogitsFlatten/flatten/Reshape/shape	Pack	CPU	1	969919	969920
Iter 202: InceptionV4/Logits/AvgPool_1a/AvgPool___tr4InceptionV4/Logits/PreLogitsFlatten/flatten/Reshape	ConvertTensor	CPU	5	969965	969970
Iter 203: InceptionV4/Logits/PreLogitsFlatten/flatten/Reshape	Reshape	CPU	4	970037	970041
Iter 204: InceptionV4/Logits/Logits/MatMul	MatMul	CPU	15348	970113	985461
Iter 205: InceptionV4/Logits/Logits/BiasAdd	BinaryOp	CPU	33	985567	985600
Iter 206: InceptionV4/Logits/Predictions	Softmax	CPU	19	985641	985660
Iter 0: InceptionV4/InceptionV4/Conv2d_1a_3x3/Conv2D	Convolution	CPU	4019	342	4361
Iter 1: InceptionV4/InceptionV4/Conv2d_2a_3x3/Conv2D	Convolution	CPU	11174	4631	15805
Iter 2: InceptionV4/InceptionV4/Conv2d_2b_3x3/Conv2D	Convolution	CPU	21455	15977	37432
Iter 3: InceptionV4/InceptionV4/Mixed_3a/Branch_0/MaxPool_0a_3x3/MaxPool	Pooling	CPU	2209	37636	39845
Iter 4: InceptionV4/InceptionV4/Mixed_3a/Branch_1/Conv2d_0a_3x3/Conv2D	Convolution	CPU	27674	39958	67632
Iter 5: InceptionV4/InceptionV4/Mixed_3a/concat	Concat	CPU	1974	67793	69767
Iter 6: InceptionV4/InceptionV4/Mixed_4a/Branch_1/Conv2d_0a_1x1/Conv2D	Convolution	CPU	4728	69827	74555
Iter 7: InceptionV4/InceptionV4/Mixed_4a/Branch_0/Conv2d_0a_1x1/Conv2D	Convolution	OpenCL	14162	69963	84125
Iter 8: InceptionV4/InceptionV4/Mixed_4a/Branch_1/Conv2d_0b_1x7/Conv2D	Convolution	CPU	14570	74676	89246
Iter 9: InceptionV4/InceptionV4/Mixed_4a/Branch_1/Conv2d_0c_7x1/Conv2D	Convolution	CPU	15786	89428	105214
Iter 10: InceptionV4/InceptionV4/Mixed_4a/Branch_0/Conv2d_1a_3x3/Conv2D	Convolution	OpenCL	29457	84293	113750
Iter 11: InceptionV4/InceptionV4/Mixed_4a/Branch_1/Conv2d_1a_3x3/Conv2D	Convolution	CPU	15936	105478	121414
Iter 12: InceptionV4/InceptionV4/Mixed_4a/concat	Concat	CPU	2968	121581	124549
Iter 13: InceptionV4/InceptionV4/Mixed_5a/Branch_0/Conv2d_1a_3x3/Conv2D	Convolution	CPU	37241	124604	161845
Iter 14: InceptionV4/InceptionV4/Mixed_5a/Branch_1/MaxPool_1a_3x3/MaxPool	Pooling	CPU	1402	162023	163425
Iter 15: InceptionV4/InceptionV4/Mixed_5a/concat	Concat	CPU	1096	163523	164619
Iter 16: InceptionV4/InceptionV4/Mixed_5b/Branch_0/Conv2d_0a_1x1/Conv2D	Convolution	CPU	3912	164675	168587
Iter 17: InceptionV4/InceptionV4/Mixed_5b/Branch_1/Conv2d_0a_1x1/Conv2D	Convolution	OpenCL	5795	164813	170608
Iter 18: InceptionV4/InceptionV4/Mixed_5b/Branch_2/Conv2d_0a_1x1/Conv2D	Convolution	CPU	2730	168729	171459
Iter 19: InceptionV4/InceptionV4/Mixed_5b/Branch_2/Conv2d_0b_3x3/Conv2D	Convolution	CPU	5279	171578	176857
Iter 20: InceptionV4/InceptionV4/Mixed_5b/Branch_1/Conv2d_0b_3x3/Conv2D	Convolution	OpenCL	8823	170763	179586
Iter 21: InceptionV4/InceptionV4/Mixed_5b/Branch_2/Conv2d_0c_3x3/Conv2D	Convolution	CPU	6630	177054	183684
Iter 22: InceptionV4/InceptionV4/Mixed_5b/Branch_3/AvgPool_0a_3x3/AvgPool	Pooling	CPU	1889	183835	185724
Iter 23: InceptionV4/InceptionV4/Mixed_5b/Branch_3/Conv2d_0b_1x1/Conv2D	Convolution	CPU	3852	185826	189678
Iter 24: InceptionV4/InceptionV4/Mixed_5b/concat	Concat	CPU	1393	189808	191201
Iter 25: InceptionV4/InceptionV4/Mixed_5c/Branch_0/Conv2d_0a_1x1/Conv2D	Convolution	CPU	4001	191255	195256
Iter 26: InceptionV4/InceptionV4/Mixed_5c/Branch_3/AvgPool_0a_3x3/AvgPool	Pooling	OpenCL	5886	191400	197286
Iter 27: InceptionV4/InceptionV4/Mixed_5c/Branch_1/Conv2d_0a_1x1/Conv2D	Convolution	CPU	2992	195419	198411
Iter 28: InceptionV4/InceptionV4/Mixed_5c/Branch_1/Conv2d_0b_3x3/Conv2D	Convolution	CPU	4028	198505	202533
Iter 29: InceptionV4/InceptionV4/Mixed_5c/Branch_3/Conv2d_0b_1x1/Conv2D	Convolution	OpenCL	6356	197454	203810
Iter 30: InceptionV4/InceptionV4/Mixed_5c/Branch_2/Conv2d_0a_1x1/Conv2D	Convolution	CPU	2787	202665	205452
Iter 31: InceptionV4/InceptionV4/Mixed_5c/Branch_2/Conv2d_0b_3x3/Conv2D	Convolution	CPU	3868	205546	209414
Iter 32: InceptionV4/InceptionV4/Mixed_5c/Branch_2/Conv2d_0c_3x3/Conv2D	Convolution	CPU	5579	209555	215134
Iter 33: InceptionV4/InceptionV4/Mixed_5c/concat	Concat	CPU	1438	215323	216761
Iter 34: InceptionV4/InceptionV4/Mixed_5d/Branch_0/Conv2d_0a_1x1/Conv2D	Convolution	CPU	4088	216817	220905
Iter 35: InceptionV4/InceptionV4/Mixed_5d/Branch_3/AvgPool_0a_3x3/AvgPool	Pooling	OpenCL	5992	216959	222951
Iter 36: InceptionV4/InceptionV4/Mixed_5d/Branch_1/Conv2d_0a_1x1/Conv2D	Convolution	CPU	2852	221072	223924
Iter 37: InceptionV4/InceptionV4/Mixed_5d/Branch_1/Conv2d_0b_3x3/Conv2D	Convolution	CPU	3958	224026	227984
Iter 38: InceptionV4/InceptionV4/Mixed_5d/Branch_3/Conv2d_0b_1x1/Conv2D	Convolution	OpenCL	7054	223113	230167
Iter 39: InceptionV4/InceptionV4/Mixed_5d/Branch_2/Conv2d_0a_1x1/Conv2D	Convolution	CPU	2792	228117	230909
Iter 40: InceptionV4/InceptionV4/Mixed_5d/Branch_2/Conv2d_0b_3x3/Conv2D	Convolution	CPU	3797	230999	234796
Iter 41: InceptionV4/InceptionV4/Mixed_5d/Branch_2/Conv2d_0c_3x3/Conv2D	Convolution	CPU	5751	234941	240692
Iter 42: InceptionV4/InceptionV4/Mixed_5d/concat	Concat	CPU	1477	240849	242326
Iter 43: InceptionV4/InceptionV4/Mixed_5e/Branch_0/Conv2d_0a_1x1/Conv2D	Convolution	CPU	4018	242381	246399
Iter 44: InceptionV4/InceptionV4/Mixed_5e/Branch_3/AvgPool_0a_3x3/AvgPool	Pooling	OpenCL	6018	242538	248556
Iter 45: InceptionV4/InceptionV4/Mixed_5e/Branch_1/Conv2d_0a_1x1/Conv2D	Convolution	CPU	3048	246572	249620
Iter 46: InceptionV4/InceptionV4/Mixed_5e/Branch_1/Conv2d_0b_3x3/Conv2D	Convolution	CPU	4055	249718	253773
Iter 47: InceptionV4/InceptionV4/Mixed_5e/Branch_3/Conv2d_0b_1x1/Conv2D	Convolution	OpenCL	6282	248824	255106
Iter 48: InceptionV4/InceptionV4/Mixed_5e/Branch_2/Conv2d_0a_1x1/Conv2D	Convolution	CPU	2821	253922	256743
Iter 49: InceptionV4/InceptionV4/Mixed_5e/Branch_2/Conv2d_0b_3x3/Conv2D	Convolution	CPU	3928	256854	260782
Iter 50: InceptionV4/InceptionV4/Mixed_5e/Branch_2/Conv2d_0c_3x3/Conv2D	Convolution	CPU	5645	260939	266584
Iter 51: InceptionV4/InceptionV4/Mixed_5e/concat	Concat	CPU	1493	266750	268243
Iter 52: InceptionV4/InceptionV4/Mixed_6a/Branch_1/Conv2d_0a_1x1/Conv2D	Convolution	CPU	7599	268304	275903
Iter 53: InceptionV4/InceptionV4/Mixed_6a/Branch_1/Conv2d_0b_3x3/Conv2D	Convolution	CPU	29473	276049	305522
Iter 54: InceptionV4/InceptionV4/Mixed_6a/Branch_1/Conv2d_1a_3x3/Conv2D	Convolution	CPU	17545	305679	323224
Iter 55: InceptionV4/InceptionV4/Mixed_6a/Branch_2/MaxPool_1a_3x3/MaxPool	Pooling	CPU	868	323370	324238
Iter 56: InceptionV4/InceptionV4/Mixed_6a/Branch_0/Conv2d_1a_3x3/Conv2D	Convolution	OpenCL	73628	268468	342096
Iter 57: InceptionV4/InceptionV4/Mixed_6a/concat	Concat	CPU	18850	324363	343213
Iter 58: InceptionV4/InceptionV4/Mixed_6b/Branch_1/Conv2d_0a_1x1/Conv2D	Convolution	OpenCL	9753	343432	353185
Iter 59: InceptionV4/InceptionV4/Mixed_6b/Branch_0/Conv2d_0a_1x1/Conv2D	Convolution	CPU	13418	343271	356689
Iter 60: InceptionV4/InceptionV4/Mixed_6b/Branch_2/Conv2d_0a_1x1/Conv2D	Convolution	CPU	6946	356793	363739
Iter 61: InceptionV4/InceptionV4/Mixed_6b/Branch_1/Conv2d_0b_1x7/Conv2D	Convolution	OpenCL	16017	353300	369317
Iter 62: InceptionV4/InceptionV4/Mixed_6b/Branch_2/Conv2d_0b_7x1/Conv2D	Convolution	CPU	8304	363878	372182
Iter 63: InceptionV4/InceptionV4/Mixed_6b/Branch_2/Conv2d_0c_1x7/Conv2D	Convolution	CPU	9007	372299	381306
Iter 64: InceptionV4/InceptionV4/Mixed_6b/Branch_1/Conv2d_0c_7x1/Conv2D	Convolution	OpenCL	19593	369447	389040
Iter 65: InceptionV4/InceptionV4/Mixed_6b/Branch_2/Conv2d_0d_7x1/Conv2D	Convolution	CPU	12246	381447	393693
Iter 66: InceptionV4/InceptionV4/Mixed_6b/Branch_3/AvgPool_0a_3x3/AvgPool	Pooling	OpenCL	7533	389214	396747
Iter 67: InceptionV4/InceptionV4/Mixed_6b/Branch_3/Conv2d_0b_1x1/Conv2D	Convolution	OpenCL	5947	396891	402838
Iter 68: InceptionV4/InceptionV4/Mixed_6b/Branch_2/Conv2d_0e_1x7/Conv2D	Convolution	CPU	13142	393907	407049
Iter 69: InceptionV4/InceptionV4/Mixed_6b/concat	Concat	CPU	1030	407182	408212
Iter 70: InceptionV4/InceptionV4/Mixed_6c/Branch_1/Conv2d_0a_1x1/Conv2D	Convolution	OpenCL	9215	408799	418014
Iter 71: InceptionV4/InceptionV4/Mixed_6c/Branch_0/Conv2d_0a_1x1/Conv2D	Convolution	CPU	13175	408279	421454
Iter 72: InceptionV4/InceptionV4/Mixed_6c/Branch_2/Conv2d_0a_1x1/Conv2D	Convolution	CPU	6829	421558	428387
Iter 73: InceptionV4/InceptionV4/Mixed_6c/Branch_1/Conv2d_0b_1x7/Conv2D	Convolution	OpenCL	15788	418124	433912
Iter 74: InceptionV4/InceptionV4/Mixed_6c/Branch_2/Conv2d_0b_7x1/Conv2D	Convolution	CPU	7930	428515	436445
Iter 75: InceptionV4/InceptionV4/Mixed_6c/Branch_2/Conv2d_0c_1x7/Conv2D	Convolution	CPU	8822	436554	445376
Iter 76: InceptionV4/InceptionV4/Mixed_6c/Branch_1/Conv2d_0c_7x1/Conv2D	Convolution	OpenCL	19577	434030	453607
Iter 77: InceptionV4/InceptionV4/Mixed_6c/Branch_2/Conv2d_0d_7x1/Conv2D	Convolution	CPU	11566	445516	457082
Iter 78: InceptionV4/InceptionV4/Mixed_6c/Branch_3/AvgPool_0a_3x3/AvgPool	Pooling	OpenCL	7295	453737	461032
Iter 79: InceptionV4/InceptionV4/Mixed_6c/Branch_3/Conv2d_0b_1x1/Conv2D	Convolution	OpenCL	5578	461143	466721
Iter 80: InceptionV4/InceptionV4/Mixed_6c/Branch_2/Conv2d_0e_1x7/Conv2D	Convolution	CPU	13743	457299	471042
Iter 81: InceptionV4/InceptionV4/Mixed_6c/concat	Concat	CPU	949	471198	472147
Iter 82: InceptionV4/InceptionV4/Mixed_6d/Branch_1/Conv2d_0a_1x1/Conv2D	Convolution	OpenCL	9198	472304	481502
Iter 83: InceptionV4/InceptionV4/Mixed_6d/Branch_0/Conv2d_0a_1x1/Conv2D	Convolution	CPU	13214	472216	485430
Iter 84: InceptionV4/InceptionV4/Mixed_6d/Branch_2/Conv2d_0a_1x1/Conv2D	Convolution	CPU	6659	485553	492212
Iter 85: InceptionV4/InceptionV4/Mixed_6d/Branch_1/Conv2d_0b_1x7/Conv2D	Convolution	OpenCL	15767	481598	497365
Iter 86: InceptionV4/InceptionV4/Mixed_6d/Branch_2/Conv2d_0b_7x1/Conv2D	Convolution	CPU	8088	492350	500438
Iter 87: InceptionV4/InceptionV4/Mixed_6d/Branch_2/Conv2d_0c_1x7/Conv2D	Convolution	CPU	8843	500551	509394
Iter 88: InceptionV4/InceptionV4/Mixed_6d/Branch_1/Conv2d_0c_7x1/Conv2D	Convolution	OpenCL	19710	497516	517226
Iter 89: InceptionV4/InceptionV4/Mixed_6d/Branch_2/Conv2d_0d_7x1/Conv2D	Convolution	CPU	12076	509520	521596
Iter 90: InceptionV4/InceptionV4/Mixed_6d/Branch_3/AvgPool_0a_3x3/AvgPool	Pooling	OpenCL	7384	517358	524742
Iter 91: InceptionV4/InceptionV4/Mixed_6d/Branch_3/Conv2d_0b_1x1/Conv2D	Convolution	OpenCL	5604	524868	530472
Iter 92: InceptionV4/InceptionV4/Mixed_6d/Branch_2/Conv2d_0e_1x7/Conv2D	Convolution	CPU	13259	521797	535056
Iter 93: InceptionV4/Logits/PreLogitsFlatten/flatten/strided_slice/stack	Const	CPU	1	535261	535262
Iter 94: InceptionV4/Logits/PreLogitsFlatten/flatten/strided_slice/stack_1	Const	CPU	1	535323	535324
Iter 95: InceptionV4/Logits/PreLogitsFlatten/flatten/strided_slice/stack_2	Const	CPU	1	535377	535378
Iter 96: InceptionV4/Logits/PreLogitsFlatten/flatten/Reshape/shape/1	Const	CPU	1	535435	535436
Iter 97: InceptionV4/Logits/Logits/weights	Const	CPU	0	535495	535495
Iter 98: InceptionV4/Logits/Logits/biases	Const	CPU	1	535553	535554
Iter 99: InceptionV4/InceptionV4/Mixed_6d/concat	Concat	OpenCL	2058	535218	537276
Iter 100: InceptionV4/InceptionV4/Mixed_6e/Branch_1/Conv2d_0a_1x1/Conv2D	Convolution	OpenCL	7656	537355	545011
Iter 101: InceptionV4/InceptionV4/Mixed_6e/Branch_0/Conv2d_0a_1x1/Conv2D	Convolution	CPU	21631	537434	559065
Iter 102: InceptionV4/InceptionV4/Mixed_6e/Branch_1/Conv2d_0b_1x7/Conv2D	Convolution	OpenCL	15532	545062	560594
Iter 103: InceptionV4/InceptionV4/Mixed_6e/Branch_2/Conv2d_0a_1x1/Conv2D	Convolution	CPU	8820	559202	568022
Iter 104: InceptionV4/InceptionV4/Mixed_6e/Branch_2/Conv2d_0b_7x1/Conv2D	Convolution	CPU	7813	568147	575960
Iter 105: InceptionV4/InceptionV4/Mixed_6e/Branch_1/Conv2d_0c_7x1/Conv2D	Convolution	OpenCL	20617	560677	581294
Iter 106: InceptionV4/InceptionV4/Mixed_6e/Branch_2/Conv2d_0c_1x7/Conv2D	Convolution	CPU	11324	576106	587430
Iter 107: InceptionV4/InceptionV4/Mixed_6e/Branch_3/AvgPool_0a_3x3/AvgPool	Pooling	OpenCL	6181	581420	587601
Iter 108: InceptionV4/InceptionV4/Mixed_6e/Branch_3/Conv2d_0b_1x1/Conv2D	Convolution	OpenCL	5605	587698	593303
Iter 109: InceptionV4/InceptionV4/Mixed_6e/Branch_2/Conv2d_0d_7x1/Conv2D	Convolution	CPU	10693	587553	598246
Iter 110: InceptionV4/InceptionV4/Mixed_6e/Branch_2/Conv2d_0e_1x7/Conv2D	Convolution	CPU	11363	598399	609762
Iter 111: InceptionV4/InceptionV4/Mixed_6e/concat	Concat	CPU	940	609985	610925
Iter 112: InceptionV4/InceptionV4/Mixed_6f/Branch_1/Conv2d_0a_1x1/Conv2D	Convolution	OpenCL	9184	611098	620282
Iter 113: InceptionV4/InceptionV4/Mixed_6f/Branch_0/Conv2d_0a_1x1/Conv2D	Convolution	CPU	12991	610998	623989
Iter 114: InceptionV4/InceptionV4/Mixed_6f/Branch_2/Conv2d_0a_1x1/Conv2D	Convolution	CPU	6737	624093	630830
Iter 115: InceptionV4/InceptionV4/Mixed_6f/Branch_1/Conv2d_0b_1x7/Conv2D	Convolution	OpenCL	15708	620428	636136
Iter 116: InceptionV4/InceptionV4/Mixed_6f/Branch_2/Conv2d_0b_7x1/Conv2D	Convolution	CPU	7966	630966	638932
Iter 117: InceptionV4/InceptionV4/Mixed_6f/Branch_2/Conv2d_0c_1x7/Conv2D	Convolution	CPU	8844	639045	647889
Iter 118: InceptionV4/InceptionV4/Mixed_6f/Branch_1/Conv2d_0c_7x1/Conv2D	Convolution	OpenCL	20590	636268	656858
Iter 119: InceptionV4/InceptionV4/Mixed_6f/Branch_2/Conv2d_0d_7x1/Conv2D	Convolution	CPU	11613	648036	659649
Iter 120: InceptionV4/InceptionV4/Mixed_6f/Branch_3/AvgPool_0a_3x3/AvgPool	Pooling	OpenCL	7214	656989	664203
Iter 121: InceptionV4/InceptionV4/Mixed_6f/Branch_3/Conv2d_0b_1x1/Conv2D	Convolution	OpenCL	5611	664334	669945
Iter 122: InceptionV4/InceptionV4/Mixed_6f/Branch_2/Conv2d_0e_1x7/Conv2D	Convolution	CPU	14144	659833	673977
Iter 123: InceptionV4/InceptionV4/Mixed_6f/concat	Concat	OpenCL	1942	674290	676232
Iter 124: InceptionV4/InceptionV4/Mixed_6g/Branch_1/Conv2d_0a_1x1/Conv2D	Convolution	OpenCL	7596	676295	683891
Iter 125: InceptionV4/InceptionV4/Mixed_6g/Branch_0/Conv2d_0a_1x1/Conv2D	Convolution	CPU	21480	676391	697871
Iter 126: InceptionV4/InceptionV4/Mixed_6g/Branch_1/Conv2d_0b_1x7/Conv2D	Convolution	OpenCL	16361	683944	700305
Iter 127: InceptionV4/InceptionV4/Mixed_6g/Branch_2/Conv2d_0a_1x1/Conv2D	Convolution	CPU	8888	698027	706915
Iter 128: InceptionV4/InceptionV4/Mixed_6g/Branch_2/Conv2d_0b_7x1/Conv2D	Convolution	CPU	7832	707058	714890
Iter 129: InceptionV4/InceptionV4/Mixed_6g/Branch_1/Conv2d_0c_7x1/Conv2D	Convolution	OpenCL	19888	700446	720334
Iter 130: InceptionV4/InceptionV4/Mixed_6g/Branch_2/Conv2d_0c_1x7/Conv2D	Convolution	CPU	11303	715099	726402
Iter 131: InceptionV4/InceptionV4/Mixed_6g/Branch_3/AvgPool_0a_3x3/AvgPool	Pooling	OpenCL	6308	720465	726773
Iter 132: InceptionV4/InceptionV4/Mixed_6g/Branch_3/Conv2d_0b_1x1/Conv2D	Convolution	OpenCL	5670	726878	732548
Iter 133: InceptionV4/InceptionV4/Mixed_6g/Branch_2/Conv2d_0d_7x1/Conv2D	Convolution	CPU	10768	726537	737305
Iter 134: InceptionV4/InceptionV4/Mixed_6g/Branch_2/Conv2d_0e_1x7/Conv2D	Convolution	CPU	11624	737534	749158
Iter 135: InceptionV4/InceptionV4/Mixed_6g/concat	Concat	OpenCL	1980	749382	751362
Iter 136: InceptionV4/InceptionV4/Mixed_6h/Branch_1/Conv2d_0a_1x1/Conv2D	Convolution	OpenCL	8348	751431	759779
Iter 137: InceptionV4/InceptionV4/Mixed_6h/Branch_0/Conv2d_0a_1x1/Conv2D	Convolution	CPU	21851	751527	773378
Iter 138: InceptionV4/InceptionV4/Mixed_6h/Branch_1/Conv2d_0b_1x7/Conv2D	Convolution	OpenCL	16189	759888	776077
Iter 139: InceptionV4/InceptionV4/Mixed_6h/Branch_2/Conv2d_0a_1x1/Conv2D	Convolution	CPU	10041	773529	783570
Iter 140: InceptionV4/InceptionV4/Mixed_6h/Branch_2/Conv2d_0b_7x1/Conv2D	Convolution	CPU	7852	783712	791564
Iter 141: InceptionV4/InceptionV4/Mixed_6h/Branch_1/Conv2d_0c_7x1/Conv2D	Convolution	OpenCL	20664	776164	796828
Iter 142: InceptionV4/InceptionV4/Mixed_6h/Branch_3/AvgPool_0a_3x3/AvgPool	Pooling	OpenCL	6224	796946	803170
Iter 143: InceptionV4/InceptionV4/Mixed_6h/Branch_2/Conv2d_0c_1x7/Conv2D	Convolution	CPU	11551	791702	803253
Iter 144: InceptionV4/InceptionV4/Mixed_6h/Branch_3/Conv2d_0b_1x1/Conv2D	Convolution	OpenCL	5653	803335	808988
Iter 145: InceptionV4/InceptionV4/Mixed_6h/Branch_2/Conv2d_0d_7x1/Conv2D	Convolution	CPU	10685	803374	814059
Iter 146: InceptionV4/InceptionV4/Mixed_6h/Branch_2/Conv2d_0e_1x7/Conv2D	Convolution	CPU	11273	814222	825495
Iter 147: InceptionV4/InceptionV4/Mixed_6h/concat	Concat	OpenCL	1983	825777	827760
Iter 148: InceptionV4/InceptionV4/Mixed_7a/Branch_0/Conv2d_0a_1x1/Conv2D	Convolution	OpenCL	7618	827824	835442
Iter 149: InceptionV4/InceptionV4/Mixed_7a/Branch_0/Conv2d_1a_3x3/Conv2D	Convolution	OpenCL	4275	835493	839768
Iter 150: InceptionV4/InceptionV4/Mixed_7a/Branch_2/MaxPool_1a_3x3/MaxPool	Pooling	OpenCL	2285	839928	842213
Iter 151: InceptionV4/InceptionV4/Mixed_7a/Branch_1/Conv2d_0a_1x1/Conv2D	Convolution	CPU	18737	827931	846668
Iter 152: InceptionV4/InceptionV4/Mixed_7a/Branch_1/Conv2d_0b_1x7/Conv2D	Convolution	CPU	13348	846802	860150
Iter 153: InceptionV4/InceptionV4/Mixed_7a/Branch_1/Conv2d_0c_7x1/Conv2D	Convolution	CPU	17059	860309	877368
Iter 154: InceptionV4/InceptionV4/Mixed_7a/Branch_1/Conv2d_1a_3x3/Conv2D	Convolution	CPU	8250	877615	885865
Iter 155: InceptionV4/InceptionV4/Mixed_7a/concat	Concat	CPU	467	886109	886576
Iter 156: InceptionV4/InceptionV4/Mixed_7b/Branch_0/Conv2d_0a_1x1/Conv2D	Convolution	OpenCL	3892	886716	890608
Iter 157: InceptionV4/InceptionV4/Mixed_7b/Branch_2/Conv2d_0a_1x1/Conv2D	Convolution	CPU	5008	886626	891634
Iter 158: InceptionV4/InceptionV4/Mixed_7b/Branch_2/Conv2d_0b_3x1/Conv2D	Convolution	CPU	4740	891739	896479
Iter 159: InceptionV4/InceptionV4/Mixed_7b/Branch_1/Conv2d_0a_1x1/Conv2D	Convolution	OpenCL	5742	890747	896489
Iter 160: InceptionV4/InceptionV4/Mixed_7b/Branch_1/Conv2d_0b_1x3/Conv2D	Convolution	OpenCL	3893	896763	900656
Iter 161: InceptionV4/InceptionV4/Mixed_7b/Branch_2/Conv2d_0c_1x3/Conv2D	Convolution	CPU	6893	896673	903566
Iter 162: InceptionV4/InceptionV4/Mixed_7b/Branch_1/Conv2d_0c_3x1/Conv2D	Convolution	OpenCL	3602	900785	904387
Iter 163: InceptionV4/InceptionV4/Mixed_7b/Branch_1/concat	Concat	OpenCL	1340	904480	905820
Iter 164: InceptionV4/InceptionV4/Mixed_7b/Branch_2/Conv2d_0d_1x3/Conv2D	Convolution	CPU	4248	903668	907916
Iter 165: InceptionV4/InceptionV4/Mixed_7b/Branch_3/AvgPool_0a_3x3/AvgPool	Pooling	OpenCL	2882	905920	908802
Iter 166: InceptionV4/InceptionV4/Mixed_7b/Branch_2/Conv2d_0e_3x1/Conv2D	Convolution	CPU	3855	908058	911913
Iter 167: InceptionV4/InceptionV4/Mixed_7b/Branch_2/concat	Concat	CPU	78	912027	912105
Iter 168: InceptionV4/InceptionV4/Mixed_7b/Branch_3/Conv2d_0b_1x1/Conv2D	Convolution	OpenCL	3398	908913	912311
Iter 169: InceptionV4/InceptionV4/Mixed_7b/concat	Concat	CPU	399	912143	912542
Iter 170: InceptionV4/InceptionV4/Mixed_7c/Branch_0/Conv2d_0a_1x1/Conv2D	Convolution	CPU	3509	912589	916098
Iter 171: InceptionV4/InceptionV4/Mixed_7c/Branch_1/Conv2d_0a_1x1/Conv2D	Convolution	OpenCL	5430	912799	918229
Iter 172: InceptionV4/InceptionV4/Mixed_7c/Branch_2/Conv2d_0a_1x1/Conv2D	Convolution	CPU	5336	916228	921564
Iter 173: InceptionV4/InceptionV4/Mixed_7c/Branch_1/Conv2d_0b_1x3/Conv2D	Convolution	OpenCL	3994	918337	922331
Iter 174: InceptionV4/InceptionV4/Mixed_7c/Branch_1/Conv2d_0c_3x1/Conv2D	Convolution	OpenCL	3681	922458	926139
Iter 175: InceptionV4/InceptionV4/Mixed_7c/Branch_2/Conv2d_0b_3x1/Conv2D	Convolution	CPU	4922	921716	926638
Iter 176: InceptionV4/InceptionV4/Mixed_7c/Branch_1/concat	Concat	OpenCL	1387	926231	927618
Iter 177: InceptionV4/InceptionV4/Mixed_7c/Branch_3/AvgPool_0a_3x3/AvgPool	Pooling	OpenCL	2965	927712	930677
Iter 178: InceptionV4/InceptionV4/Mixed_7c/Branch_2/Conv2d_0c_1x3/Conv2D	Convolution	CPU	7115	926717	933832
Iter 179: InceptionV4/InceptionV4/Mixed_7c/Branch_3/Conv2d_0b_1x1/Conv2D	Convolution	OpenCL	3322	930802	934124
Iter 180: InceptionV4/InceptionV4/Mixed_7c/Branch_2/Conv2d_0d_1x3/Conv2D	Convolution	CPU	3373	933926	937299
Iter 181: InceptionV4/InceptionV4/Mixed_7c/Branch_2/Conv2d_0e_3x1/Conv2D	Convolution	CPU	3408	937445	940853
Iter 182: InceptionV4/InceptionV4/Mixed_7c/Branch_2/concat	Concat	CPU	86	941147	941233
Iter 183: InceptionV4/InceptionV4/Mixed_7c/concat	Concat	CPU	372	941286	941658
Iter 184: InceptionV4/InceptionV4/Mixed_7d/Branch_0/Conv2d_0a_1x1/Conv2D	Convolution	CPU	3421	941706	945127
Iter 185: InceptionV4/InceptionV4/Mixed_7d/Branch_1/Conv2d_0a_1x1/Conv2D	Convolution	OpenCL	5617	941825	947442
Iter 186: InceptionV4/InceptionV4/Mixed_7d/Branch_2/Conv2d_0a_1x1/Conv2D	Convolution	CPU	5284	945256	950540
Iter 187: InceptionV4/InceptionV4/Mixed_7d/Branch_1/Conv2d_0b_1x3/Conv2D	Convolution	OpenCL	4456	947616	952072
Iter 188: InceptionV4/InceptionV4/Mixed_7d/Branch_2/Conv2d_0b_3x1/Conv2D	Convolution	CPU	5032	950681	955713
Iter 189: InceptionV4/InceptionV4/Mixed_7d/Branch_1/Conv2d_0c_3x1/Conv2D	Convolution	OpenCL	3616	952177	955793
Iter 190: InceptionV4/InceptionV4/Mixed_7d/Branch_1/concat	Concat	OpenCL	1413	955876	957289
Iter 191: InceptionV4/InceptionV4/Mixed_7d/Branch_3/AvgPool_0a_3x3/AvgPool	Pooling	OpenCL	3047	957388	960435
Iter 192: InceptionV4/InceptionV4/Mixed_7d/Branch_2/Conv2d_0c_1x3/Conv2D	Convolution	CPU	7119	955923	963042
Iter 193: InceptionV4/InceptionV4/Mixed_7d/Branch_3/Conv2d_0b_1x1/Conv2D	Convolution	OpenCL	3305	960557	963862
Iter 194: InceptionV4/InceptionV4/Mixed_7d/Branch_2/Conv2d_0d_1x3/Conv2D	Convolution	CPU	3413	963134	966547
Iter 195: InceptionV4/InceptionV4/Mixed_7d/Branch_2/Conv2d_0e_3x1/Conv2D	Convolution	CPU	3398	966650	970048
Iter 196: InceptionV4/InceptionV4/Mixed_7d/Branch_2/concat	Concat	CPU	75	970171	970246
Iter 197: InceptionV4/InceptionV4/Mixed_7d/concat	Concat	CPU	332	970294	970626
Iter 198: InceptionV4/Logits/AvgPool_1a/AvgPool	Pooling	CPU	149	970672	970821
Iter 199: InceptionV4/Logits/PreLogitsFlatten/flatten/Shape	Shape	CPU	1	970883	970884
Iter 200: InceptionV4/Logits/PreLogitsFlatten/flatten/strided_slice	StridedSlice	CPU	1	970932	970933
Iter 201: InceptionV4/Logits/PreLogitsFlatten/flatten/Reshape/shape	Pack	CPU	1	970982	970983
Iter 202: InceptionV4/Logits/AvgPool_1a/AvgPool___tr4InceptionV4/Logits/PreLogitsFlatten/flatten/Reshape	ConvertTensor	CPU	5	971030	971035
Iter 203: InceptionV4/Logits/PreLogitsFlatten/flatten/Reshape	Reshape	CPU	4	971079	971083
Iter 204: InceptionV4/Logits/Logits/MatMul	MatMul	CPU	15238	971126	986364
Iter 205: InceptionV4/Logits/Logits/BiasAdd	BinaryOp	CPU	32	986476	986508
Iter 206: InceptionV4/Logits/Predictions	Softmax	CPU	19	986556	986575
Iter 0: InceptionV4/InceptionV4/Conv2d_1a_3x3/Conv2D	Convolution	CPU	4014	382	4396
Iter 1: InceptionV4/InceptionV4/Conv2d_2a_3x3/Conv2D	Convolution	CPU	11120	4626	15746
Iter 2: InceptionV4/InceptionV4/Conv2d_2b_3x3/Conv2D	Convolution	CPU	21424	15977	37401
Iter 3: InceptionV4/InceptionV4/Mixed_3a/Branch_0/MaxPool_0a_3x3/MaxPool	Pooling	CPU	1639	37556	39195
Iter 4: InceptionV4/InceptionV4/Mixed_3a/Branch_1/Conv2d_0a_3x3/Conv2D	Convolution	CPU	27485	39307	66792
Iter 5: InceptionV4/InceptionV4/Mixed_3a/concat	Concat	CPU	1780	66998	68778
Iter 6: InceptionV4/InceptionV4/Mixed_4a/Branch_1/Conv2d_0a_1x1/Conv2D	Convolution	CPU	4728	68843	73571
Iter 7: InceptionV4/InceptionV4/Mixed_4a/Branch_0/Conv2d_0a_1x1/Conv2D	Convolution	OpenCL	13625	69048	82673
Iter 8: InceptionV4/InceptionV4/Mixed_4a/Branch_1/Conv2d_0b_1x7/Conv2D	Convolution	CPU	14554	73701	88255
Iter 9: InceptionV4/InceptionV4/Mixed_4a/Branch_1/Conv2d_0c_7x1/Conv2D	Convolution	CPU	15880	88448	104328
Iter 10: InceptionV4/InceptionV4/Mixed_4a/Branch_0/Conv2d_1a_3x3/Conv2D	Convolution	OpenCL	29250	82773	112023
Iter 11: InceptionV4/InceptionV4/Mixed_4a/Branch_1/Conv2d_1a_3x3/Conv2D	Convolution	CPU	15181	104595	119776
Iter 12: InceptionV4/InceptionV4/Mixed_4a/concat	Concat	CPU	2785	120093	122878
Iter 13: InceptionV4/InceptionV4/Mixed_5a/Branch_0/Conv2d_1a_3x3/Conv2D	Convolution	CPU	37202	122952	160154
Iter 14: InceptionV4/InceptionV4/Mixed_5a/Branch_1/MaxPool_1a_3x3/MaxPool	Pooling	CPU	1294	160428	161722
Iter 15: InceptionV4/InceptionV4/Mixed_5a/concat	Concat	CPU	1125	161855	162980
Iter 16: InceptionV4/InceptionV4/Mixed_5b/Branch_0/Conv2d_0a_1x1/Conv2D	Convolution	CPU	3802	163062	166864
Iter 17: InceptionV4/InceptionV4/Mixed_5b/Branch_1/Conv2d_0a_1x1/Conv2D	Convolution	OpenCL	5956	163192	169148
Iter 18: InceptionV4/InceptionV4/Mixed_5b/Branch_2/Conv2d_0a_1x1/Conv2D	Convolution	CPU	2768	167007	169775
Iter 19: InceptionV4/InceptionV4/Mixed_5b/Branch_2/Conv2d_0b_3x3/Conv2D	Convolution	CPU	5299	169903	175202
Iter 20: InceptionV4/InceptionV4/Mixed_5b/Branch_1/Conv2d_0b_3x3/Conv2D	Convolution	OpenCL	9194	169274	178468
Iter 21: InceptionV4/InceptionV4/Mixed_5b/Branch_2/Conv2d_0c_3x3/Conv2D	Convolution	CPU	6894	175412	182306
Iter 22: InceptionV4/InceptionV4/Mixed_5b/Branch_3/AvgPool_0a_3x3/AvgPool	Pooling	CPU	1885	182633	184518
Iter 23: InceptionV4/InceptionV4/Mixed_5b/Branch_3/Conv2d_0b_1x1/Conv2D	Convolution	CPU	3795	184662	188457
Iter 24: InceptionV4/InceptionV4/Mixed_5b/concat	Concat	CPU	1534	188588	190122
Iter 25: InceptionV4/InceptionV4/Mixed_5c/Branch_0/Conv2d_0a_1x1/Conv2D	Convolution	CPU	4014	190199	194213
Iter 26: InceptionV4/InceptionV4/Mixed_5c/Branch_3/AvgPool_0a_3x3/AvgPool	Pooling	OpenCL	6074	190294	196368
Iter 27: InceptionV4/InceptionV4/Mixed_5c/Branch_1/Conv2d_0a_1x1/Conv2D	Convolution	CPU	2891	194389	197280
Iter 28: InceptionV4/InceptionV4/Mixed_5c/Branch_1/Conv2d_0b_3x3/Conv2D	Convolution	CPU	4188	197390	201578
Iter 29: InceptionV4/InceptionV4/Mixed_5c/Branch_3/Conv2d_0b_1x1/Conv2D	Convolution	OpenCL	6464	196475	202939
Iter 30: InceptionV4/InceptionV4/Mixed_5c/Branch_2/Conv2d_0a_1x1/Conv2D	Convolution	CPU	2764	201722	204486
Iter 31: InceptionV4/InceptionV4/Mixed_5c/Branch_2/Conv2d_0b_3x3/Conv2D	Convolution	CPU	3807	204611	208418
Iter 32: InceptionV4/InceptionV4/Mixed_5c/Branch_2/Conv2d_0c_3x3/Conv2D	Convolution	CPU	5662	208637	214299
Iter 33: InceptionV4/InceptionV4/Mixed_5c/concat	Concat	CPU	1388	214554	215942
Iter 34: InceptionV4/InceptionV4/Mixed_5d/Branch_0/Conv2d_0a_1x1/Conv2D	Convolution	CPU	4076	216019	220095
Iter 35: InceptionV4/InceptionV4/Mixed_5d/Branch_3/AvgPool_0a_3x3/AvgPool	Pooling	OpenCL	6133	216113	222246
Iter 36: InceptionV4/InceptionV4/Mixed_5d/Branch_1/Conv2d_0a_1x1/Conv2D	Convolution	CPU	2866	220249	223115
Iter 37: InceptionV4/InceptionV4/Mixed_5d/Branch_1/Conv2d_0b_3x3/Conv2D	Convolution	CPU	3978	223216	227194
Iter 38: InceptionV4/InceptionV4/Mixed_5d/Branch_3/Conv2d_0b_1x1/Conv2D	Convolution	OpenCL	7386	222341	229727
Iter 39: InceptionV4/InceptionV4/Mixed_5d/Branch_2/Conv2d_0a_1x1/Conv2D	Convolution	CPU	2890	227327	230217
Iter 40: InceptionV4/InceptionV4/Mixed_5d/Branch_2/Conv2d_0b_3x3/Conv2D	Convolution	CPU	3847	230323	234170
Iter 41: InceptionV4/InceptionV4/Mixed_5d/Branch_2/Conv2d_0c_3x3/Conv2D	Convolution	CPU	5690	234438	240128
Iter 42: InceptionV4/InceptionV4/Mixed_5d/concat	Concat	CPU	1362	240385	241747
Iter 43: InceptionV4/InceptionV4/Mixed_5e/Branch_0/Conv2d_0a_1x1/Conv2D	Convolution	CPU	4021	241819	245840
Iter 44: InceptionV4/InceptionV4/Mixed_5e/Branch_3/AvgPool_0a_3x3/AvgPool	Pooling	OpenCL	6099	241901	248000
Iter 45: InceptionV4/InceptionV4/Mixed_5e/Branch_1/Conv2d_0a_1x1/Conv2D	Convolution	CPU	2861	246009	248870
Iter 46: InceptionV4/InceptionV4/Mixed_5e/Branch_1/Conv2d_0b_3x3/Conv2D	Convolution	CPU	4069	248962	253031
Iter 47: InceptionV4/InceptionV4/Mixed_5e/Branch_3/Conv2d_0b_1x1/Conv2D	Convolution	OpenCL	6445	248121	254566
Iter 48: InceptionV4/InceptionV4/Mixed_5e/Branch_2/Conv2d_0a_1x1/Conv2D	Convolution	CPU	2799	253171	255970
Iter 49: InceptionV4/InceptionV4/Mixed_5e/Branch_2/Conv2d_0b_3x3/Conv2D	Convolution	CPU	3874	256075	259949
Iter 50: InceptionV4/InceptionV4/Mixed_5e/Branch_2/Conv2d_0c_3x3/Conv2D	Convolution	CPU	5605	260111	265716
Iter 51: InceptionV4/InceptionV4/Mixed_5e/concat	Concat	CPU	1396	265888	267284
Iter 52: InceptionV4/InceptionV4/Mixed_6a/Branch_1/Conv2d_0a_1x1/Conv2D	Convolution	CPU	7680	267356	275036
Iter 53: InceptionV4/InceptionV4/Mixed_6a/Branch_1/Conv2d_0b_3x3/Conv2D	Convolution	CPU	26430	275192	301622
Iter 54: InceptionV4/InceptionV4/Mixed_6a/Branch_1/Conv2d_1a_3x3/Conv2D	Convolution	CPU	17169	301782	318951
Iter 55: InceptionV4/InceptionV4/Mixed_6a/Branch_2/MaxPool_1a_3x3/MaxPool	Pooling	CPU	847	319152	319999
Iter 56: InceptionV4/InceptionV4/Mixed_6a/Branch_0/Conv2d_1a_3x3/Conv2D	Convolution	OpenCL	73299	267440	340739
Iter 57: InceptionV4/InceptionV4/Mixed_6a/concat	Concat	CPU	21642	320125	341767
Iter 58: InceptionV4/InceptionV4/Mixed_6b/Branch_1/Conv2d_0a_1x1/Conv2D	Convolution	OpenCL	9455	341926	351381
Iter 59: InceptionV4/InceptionV4/Mixed_6b/Branch_0/Conv2d_0a_1x1/Conv2D	Convolution	CPU	13237	341833	355070
Iter 60: InceptionV4/InceptionV4/Mixed_6b/Branch_2/Conv2d_0a_1x1/Conv2D	Convolution	CPU	6805	355185	361990
Iter 61: InceptionV4/InceptionV4/Mixed_6b/Branch_1/Conv2d_0b_1x7/Conv2D	Convolution	OpenCL	15874	351507	367381
Iter 62: InceptionV4/InceptionV4/Mixed_6b/Branch_2/Conv2d_0b_7x1/Conv2D	Convolution	CPU	8079	362134	370213
Iter 63: InceptionV4/InceptionV4/Mixed_6b/Branch_2/Conv2d_0c_1x7/Conv2D	Convolution	CPU	8927	370327	379254
Iter 64: InceptionV4/InceptionV4/Mixed_6b/Branch_1/Conv2d_0c_7x1/Conv2D	Convolution	OpenCL	19649	367501	387150
Iter 65: InceptionV4/InceptionV4/Mixed_6b/Branch_2/Conv2d_0d_7x1/Conv2D	Convolution	CPU	11769	379394	391163
Iter 66: InceptionV4/InceptionV4/Mixed_6b/Branch_3/AvgPool_0a_3x3/AvgPool	Pooling	OpenCL	7668	387352	395020
Iter 67: InceptionV4/InceptionV4/Mixed_6b/Branch_3/Conv2d_0b_1x1/Conv2D	Convolution	OpenCL	5720	395184	400904
Iter 68: InceptionV4/InceptionV4/Mixed_6b/Branch_2/Conv2d_0e_1x7/Conv2D	Convolution	CPU	13730	391382	405112
Iter 69: InceptionV4/InceptionV4/Mixed_6b/concat	Concat	CPU	965	405314	406279
Iter 70: InceptionV4/InceptionV4/Mixed_6c/Branch_1/Conv2d_0a_1x1/Conv2D	Convolution	OpenCL	9517	406432	415949
Iter 71: InceptionV4/InceptionV4/Mixed_6c/Branch_0/Conv2d_0a_1x1/Conv2D	Convolution	CPU	13159	406354	419513
Iter 72: InceptionV4/InceptionV4/Mixed_6c/Branch_2/Conv2d_0a_1x1/Conv2D	Convolution	CPU	6794	419618	426412
Iter 73: InceptionV4/InceptionV4/Mixed_6c/Branch_1/Conv2d_0b_1x7/Conv2D	Convolution	OpenCL	16116	416071	432187
Iter 74: InceptionV4/InceptionV4/Mixed_6c/Branch_2/Conv2d_0b_7x1/Conv2D	Convolution	CPU	8050	426558	434608
Iter 75: InceptionV4/InceptionV4/Mixed_6c/Branch_2/Conv2d_0c_1x7/Conv2D	Convolution	CPU	8919	434725	443644
Iter 76: InceptionV4/InceptionV4/Mixed_6c/Branch_1/Conv2d_0c_7x1/Conv2D	Convolution	OpenCL	19698	432300	451998
Iter 77: InceptionV4/InceptionV4/Mixed_6c/Branch_2/Conv2d_0d_7x1/Conv2D	Convolution	CPU	11661	443791	455452
Iter 78: InceptionV4/InceptionV4/Mixed_6c/Branch_3/AvgPool_0a_3x3/AvgPool	Pooling	OpenCL	7532	452124	459656
Iter 79: InceptionV4/InceptionV4/Mixed_6c/Branch_3/Conv2d_0b_1x1/Conv2D	Convolution	OpenCL	5664	459790	465454
Iter 80: InceptionV4/InceptionV4/Mixed_6c/Branch_2/Conv2d_0e_1x7/Conv2D	Convolution	CPU	13943	455659	469602
Iter 81: InceptionV4/InceptionV4/Mixed_6c/concat	Concat	CPU	1029	469867	470896
Iter 82: InceptionV4/InceptionV4/Mixed_6d/Branch_1/Conv2d_0a_1x1/Conv2D	Convolution	OpenCL	9331	471078	480409
Iter 83: InceptionV4/InceptionV4/Mixed_6d/Branch_0/Conv2d_0a_1x1/Conv2D	Convolution	CPU	13028	470974	484002
Iter 84: InceptionV4/InceptionV4/Mixed_6d/Branch_2/Conv2d_0a_1x1/Conv2D	Convolution	CPU	6715	484117	490832
Iter 85: InceptionV4/InceptionV4/Mixed_6d/Branch_1/Conv2d_0b_1x7/Conv2D	Convolution	OpenCL	15888	480698	496586
Iter 86: InceptionV4/InceptionV4/Mixed_6d/Branch_2/Conv2d_0b_7x1/Conv2D	Convolution	CPU	8121	490975	499096
Iter 87: InceptionV4/InceptionV4/Mixed_6d/Branch_2/Conv2d_0c_1x7/Conv2D	Convolution	CPU	8753	499204	507957
Iter 88: InceptionV4/InceptionV4/Mixed_6d/Branch_1/Conv2d_0c_7x1/Conv2D	Convolution	OpenCL	19916	496881	516797
Iter 89: InceptionV4/InceptionV4/Mixed_6d/Branch_2/Conv2d_0d_7x1/Conv2D	Convolution	CPU	11845	508106	519951
Iter 90: InceptionV4/InceptionV4/Mixed_6d/Branch_3/AvgPool_0a_3x3/AvgPool	Pooling	OpenCL	7389	516915	524304
Iter 91: InceptionV4/InceptionV4/Mixed_6d/Branch_3/Conv2d_0b_1x1/Conv2D	Convolution	OpenCL	5672	524424	530096
Iter 92: InceptionV4/InceptionV4/Mixed_6d/Branch_2/Conv2d_0e_1x7/Conv2D	Convolution	CPU	14067	520157	534224
Iter 93: InceptionV4/Logits/PreLogitsFlatten/flatten/strided_slice/stack	Const	CPU	2	534433	534435
Iter 94: InceptionV4/Logits/PreLogitsFlatten/flatten/strided_slice/stack_1	Const	CPU	0	534509	534509
Iter 95: InceptionV4/Logits/PreLogitsFlatten/flatten/strided_slice/stack_2	Const	CPU	0	534578	534578
Iter 96: InceptionV4/Logits/PreLogitsFlatten/flatten/Reshape/shape/1	Const	CPU	2	534853	534855
Iter 97: InceptionV4/Logits/Logits/weights	Const	CPU	1	534917	534918
Iter 98: InceptionV4/Logits/Logits/biases	Const	CPU	0	534983	534983
Iter 99: InceptionV4/InceptionV4/Mixed_6d/concat	Concat	OpenCL	2167	534701	536868
Iter 100: InceptionV4/InceptionV4/Mixed_6e/Branch_1/Conv2d_0a_1x1/Conv2D	Convolution	OpenCL	7671	536947	544618
Iter 101: InceptionV4/InceptionV4/Mixed_6e/Branch_0/Conv2d_0a_1x1/Conv2D	Convolution	CPU	21700	537019	558719
Iter 102: InceptionV4/InceptionV4/Mixed_6e/Branch_1/Conv2d_0b_1x7/Conv2D	Convolution	OpenCL	15770	544670	560440
Iter 103: InceptionV4/InceptionV4/Mixed_6e/Branch_2/Conv2d_0a_1x1/Conv2D	Convolution	CPU	9032	558885	567917
Iter 104: InceptionV4/InceptionV4/Mixed_6e/Branch_2/Conv2d_0b_7x1/Conv2D	Convolution	CPU	7952	568053	576005
Iter 105: InceptionV4/InceptionV4/Mixed_6e/Branch_1/Conv2d_0c_7x1/Conv2D	Convolution	OpenCL	20695	560502	581197
Iter 106: InceptionV4/InceptionV4/Mixed_6e/Branch_3/AvgPool_0a_3x3/AvgPool	Pooling	OpenCL	6220	581335	587555
Iter 107: InceptionV4/InceptionV4/Mixed_6e/Branch_2/Conv2d_0c_1x7/Conv2D	Convolution	CPU	11607	576143	587750
Iter 108: InceptionV4/InceptionV4/Mixed_6e/Branch_3/Conv2d_0b_1x1/Conv2D	Convolution	OpenCL	5801	587653	593454
Iter 109: InceptionV4/InceptionV4/Mixed_6e/Branch_2/Conv2d_0d_7x1/Conv2D	Convolution	CPU	10663	587832	598495
Iter 110: InceptionV4/InceptionV4/Mixed_6e/Branch_2/Conv2d_0e_1x7/Conv2D	Convolution	CPU	11357	598719	610076
Iter 111: InceptionV4/InceptionV4/Mixed_6e/concat	Concat	CPU	980	610241	611221
Iter 112: InceptionV4/InceptionV4/Mixed_6f/Branch_1/Conv2d_0a_1x1/Conv2D	Convolution	OpenCL	9252	611382	620634
Iter 113: InceptionV4/InceptionV4/Mixed_6f/Branch_0/Conv2d_0a_1x1/Conv2D	Convolution	CPU	13090	611295	624385
Iter 114: InceptionV4/InceptionV4/Mixed_6f/Branch_2/Conv2d_0a_1x1/Conv2D	Convolution	CPU	6743	624492	631235
Iter 115: InceptionV4/InceptionV4/Mixed_6f/Branch_1/Conv2d_0b_1x7/Conv2D	Convolution	OpenCL	15977	620745	636722
Iter 116: InceptionV4/InceptionV4/Mixed_6f/Branch_2/Conv2d_0b_7x1/Conv2D	Convolution	CPU	8045	631386	639431
Iter 117: InceptionV4/InceptionV4/Mixed_6f/Branch_2/Conv2d_0c_1x7/Conv2D	Convolution	CPU	8835	639537	648372
Iter 118: InceptionV4/InceptionV4/Mixed_6f/Branch_1/Conv2d_0c_7x1/Conv2D	Convolution	OpenCL	20398	636841	657239
Iter 119: InceptionV4/InceptionV4/Mixed_6f/Branch_2/Conv2d_0d_7x1/Conv2D	Convolution	CPU	11910	648514	660424
Iter 120: InceptionV4/InceptionV4/Mixed_6f/Branch_3/AvgPool_0a_3x3/AvgPool	Pooling	OpenCL	7386	657360	664746
Iter 121: InceptionV4/InceptionV4/Mixed_6f/Branch_3/Conv2d_0b_1x1/Conv2D	Convolution	OpenCL	5705	664875	670580
Iter 122: InceptionV4/InceptionV4/Mixed_6f/Branch_2/Conv2d_0e_1x7/Conv2D	Convolution	CPU	14153	660625	674778
Iter 123: InceptionV4/InceptionV4/Mixed_6f/concat	Concat	OpenCL	2077	675036	677113
Iter 124: InceptionV4/InceptionV4/Mixed_6g/Branch_1/Conv2d_0a_1x1/Conv2D	Convolution	OpenCL	7635	677180	684815
Iter 125: InceptionV4/InceptionV4/Mixed_6g/Branch_0/Conv2d_0a_1x1/Conv2D	Convolution	CPU	21592	677271	698863
Iter 126: InceptionV4/InceptionV4/Mixed_6g/Branch_1/Conv2d_0b_1x7/Conv2D	Convolution	OpenCL	15776	684866	700642
Iter 127: InceptionV4/InceptionV4/Mixed_6g/Branch_2/Conv2d_0a_1x1/Conv2D	Convolution	CPU	10116	699085	709201
Iter 128: InceptionV4/InceptionV4/Mixed_6g/Branch_2/Conv2d_0b_7x1/Conv2D	Convolution	CPU	7937	709342	717279
Iter 129: InceptionV4/InceptionV4/Mixed_6g/Branch_1/Conv2d_0c_7x1/Conv2D	Convolution	OpenCL	20753	700709	721462
Iter 130: InceptionV4/InceptionV4/Mixed_6g/Branch_3/AvgPool_0a_3x3/AvgPool	Pooling	OpenCL	6333	721598	727931
Iter 131: InceptionV4/InceptionV4/Mixed_6g/Branch_2/Conv2d_0c_1x7/Conv2D	Convolution	CPU	12038	717504	729542
Iter 132: InceptionV4/InceptionV4/Mixed_6g/Branch_3/Conv2d_0b_1x1/Conv2D	Convolution	OpenCL	5723	728086	733809
Iter 133: InceptionV4/InceptionV4/Mixed_6g/Branch_2/Conv2d_0d_7x1/Conv2D	Convolution	CPU	10773	729632	740405
Iter 134: InceptionV4/InceptionV4/Mixed_6g/Branch_2/Conv2d_0e_1x7/Conv2D	Convolution	CPU	11408	740550	751958
Iter 135: InceptionV4/InceptionV4/Mixed_6g/concat	Concat	OpenCL	2213	752355	754568
Iter 136: InceptionV4/InceptionV4/Mixed_6h/Branch_1/Conv2d_0a_1x1/Conv2D	Convolution	OpenCL	8226	754697	762923
Iter 137: InceptionV4/InceptionV4/Mixed_6h/Branch_0/Conv2d_0a_1x1/Conv2D	Convolution	CPU	21893	754760	776653
Iter 138: InceptionV4/InceptionV4/Mixed_6h/Branch_1/Conv2d_0b_1x7/Conv2D	Convolution	OpenCL	16444	763030	779474
Iter 139: InceptionV4/InceptionV4/Mixed_6h/Branch_2/Conv2d_0a_1x1/Conv2D	Convolution	CPU	10190	776811	787001
Iter 140: InceptionV4/InceptionV4/Mixed_6h/Branch_2/Conv2d_0b_7x1/Conv2D	Convolution	CPU	7943	787151	795094
Iter 141: InceptionV4/InceptionV4/Mixed_6h/Branch_1/Conv2d_0c_7x1/Conv2D	Convolution	OpenCL	20715	779564	800279
Iter 142: InceptionV4/InceptionV4/Mixed_6h/Branch_3/AvgPool_0a_3x3/AvgPool	Pooling	OpenCL	6264	800398	806662
Iter 143: InceptionV4/InceptionV4/Mixed_6h/Branch_2/Conv2d_0c_1x7/Conv2D	Convolution	CPU	11611	795232	806843
Iter 144: InceptionV4/InceptionV4/Mixed_6h/Branch_3/Conv2d_0b_1x1/Conv2D	Convolution	OpenCL	5881	806789	812670
Iter 145: InceptionV4/InceptionV4/Mixed_6h/Branch_2/Conv2d_0d_7x1/Conv2D	Convolution	CPU	10778	806928	817706
Iter 146: InceptionV4/InceptionV4/Mixed_6h/Branch_2/Conv2d_0e_1x7/Conv2D	Convolution	CPU	11414	817957	829371
Iter 147: InceptionV4/InceptionV4/Mixed_6h/concat	Concat	OpenCL	2046	829575	831621
Iter 148: InceptionV4/InceptionV4/Mixed_7a/Branch_0/Conv2d_0a_1x1/Conv2D	Convolution	OpenCL	7636	831681	839317
Iter 149: InceptionV4/InceptionV4/Mixed_7a/Branch_0/Conv2d_1a_3x3/Conv2D	Convolution	OpenCL	4324	839368	843692
Iter 150: InceptionV4/InceptionV4/Mixed_7a/Branch_2/MaxPool_1a_3x3/MaxPool	Pooling	OpenCL	2322	843800	846122
Iter 151: InceptionV4/InceptionV4/Mixed_7a/Branch_1/Conv2d_0a_1x1/Conv2D	Convolution	CPU	20198	831777	851975
Iter 152: InceptionV4/InceptionV4/Mixed_7a/Branch_1/Conv2d_0b_1x7/Conv2D	Convolution	CPU	13339	852110	865449
Iter 153: InceptionV4/InceptionV4/Mixed_7a/Branch_1/Conv2d_0c_7x1/Conv2D	Convolution	CPU	17214	865698	882912
Iter 154: InceptionV4/InceptionV4/Mixed_7a/Branch_1/Conv2d_1a_3x3/Conv2D	Convolution	CPU	8523	883231	891754
Iter 155: InceptionV4/InceptionV4/Mixed_7a/concat	Concat	CPU	471	891899	892370
Iter 156: InceptionV4/InceptionV4/Mixed_7b/Branch_0/Conv2d_0a_1x1/Conv2D	Convolution	OpenCL	4217	892615	896832
Iter 157: InceptionV4/InceptionV4/Mixed_7b/Branch_2/Conv2d_0a_1x1/Conv2D	Convolution	CPU	5061	892420	897481
Iter 158: InceptionV4/InceptionV4/Mixed_7b/Branch_2/Conv2d_0b_3x1/Conv2D	Convolution	CPU	4941	897582	902523
Iter 159: InceptionV4/InceptionV4/Mixed_7b/Branch_1/Conv2d_0a_1x1/Conv2D	Convolution	OpenCL	5741	896946	902687
Iter 160: InceptionV4/InceptionV4/Mixed_7b/Branch_1/Conv2d_0b_1x3/Conv2D	Convolution	OpenCL	4108	902772	906880
Iter 161: InceptionV4/InceptionV4/Mixed_7b/Branch_2/Conv2d_0c_1x3/Conv2D	Convolution	CPU	6986	902642	909628
Iter 162: InceptionV4/InceptionV4/Mixed_7b/Branch_1/Conv2d_0c_3x1/Conv2D	Convolution	OpenCL	3683	906973	910656
Iter 163: InceptionV4/InceptionV4/Mixed_7b/Branch_1/concat	Concat	OpenCL	1351	910781	912132
Iter 164: InceptionV4/InceptionV4/Mixed_7b/Branch_2/Conv2d_0d_1x3/Conv2D	Convolution	CPU	4162	909738	913900
Iter 165: InceptionV4/InceptionV4/Mixed_7b/Branch_3/AvgPool_0a_3x3/AvgPool	Pooling	OpenCL	3240	912234	915474
Iter 166: InceptionV4/InceptionV4/Mixed_7b/Branch_2/Conv2d_0e_3x1/Conv2D	Convolution	CPU	4196	914080	918276
Iter 167: InceptionV4/InceptionV4/Mixed_7b/Branch_2/concat	Concat	CPU	90	918392	918482
Iter 168: InceptionV4/InceptionV4/Mixed_7b/Branch_3/Conv2d_0b_1x1/Conv2D	Convolution	OpenCL	3345	915596	918941
Iter 169: InceptionV4/InceptionV4/Mixed_7b/concat	Concat	CPU	893	918528	919421
Iter 170: InceptionV4/InceptionV4/Mixed_7c/Branch_0/Conv2d_0a_1x1/Conv2D	Convolution	CPU	3751	919471	923222
Iter 171: InceptionV4/InceptionV4/Mixed_7c/Branch_1/Conv2d_0a_1x1/Conv2D	Convolution	OpenCL	5770	919528	925298
Iter 172: InceptionV4/InceptionV4/Mixed_7c/Branch_2/Conv2d_0a_1x1/Conv2D	Convolution	CPU	5799	923353	929152
Iter 173: InceptionV4/InceptionV4/Mixed_7c/Branch_1/Conv2d_0b_1x3/Conv2D	Convolution	OpenCL	4044	925396	929440
Iter 174: InceptionV4/InceptionV4/Mixed_7c/Branch_1/Conv2d_0c_3x1/Conv2D	Convolution	OpenCL	3821	929518	933339
Iter 175: InceptionV4/InceptionV4/Mixed_7c/Branch_2/Conv2d_0b_3x1/Conv2D	Convolution	CPU	5069	929297	934366
Iter 176: InceptionV4/InceptionV4/Mixed_7c/Branch_1/concat	Concat	OpenCL	1369	933443	934812
Iter 177: InceptionV4/InceptionV4/Mixed_7c/Branch_3/AvgPool_0a_3x3/AvgPool	Pooling	OpenCL	3273	934916	938189
Iter 178: InceptionV4/InceptionV4/Mixed_7c/Branch_2/Conv2d_0c_1x3/Conv2D	Convolution	CPU	7264	934448	941712
Iter 179: InceptionV4/InceptionV4/Mixed_7c/Branch_3/Conv2d_0b_1x1/Conv2D	Convolution	OpenCL	3433	938355	941788
Iter 180: InceptionV4/InceptionV4/Mixed_7c/Branch_2/Conv2d_0d_1x3/Conv2D	Convolution	CPU	3444	941956	945400
Iter 181: InceptionV4/InceptionV4/Mixed_7c/Branch_2/Conv2d_0e_3x1/Conv2D	Convolution	CPU	3513	945533	949046
Iter 182: InceptionV4/InceptionV4/Mixed_7c/Branch_2/concat	Concat	CPU	96	949185	949281
Iter 183: InceptionV4/InceptionV4/Mixed_7c/concat	Concat	CPU	381	949343	949724
Iter 184: InceptionV4/InceptionV4/Mixed_7d/Branch_0/Conv2d_0a_1x1/Conv2D	Convolution	CPU	3735	949771	953506
Iter 185: InceptionV4/InceptionV4/Mixed_7d/Branch_1/Conv2d_0a_1x1/Conv2D	Convolution	OpenCL	5750	949934	955684
Iter 186: InceptionV4/InceptionV4/Mixed_7d/Branch_2/Conv2d_0a_1x1/Conv2D	Convolution	CPU	5818	953637	959455
Iter 187: InceptionV4/InceptionV4/Mixed_7d/Branch_1/Conv2d_0b_1x3/Conv2D	Convolution	OpenCL	4772	955860	960632
Iter 188: InceptionV4/InceptionV4/Mixed_7d/Branch_1/Conv2d_0c_3x1/Conv2D	Convolution	OpenCL	3717	960796	964513
Iter 189: InceptionV4/InceptionV4/Mixed_7d/Branch_2/Conv2d_0b_3x1/Conv2D	Convolution	CPU	5151	959601	964752
Iter 190: InceptionV4/InceptionV4/Mixed_7d/Branch_1/concat	Concat	OpenCL	1386	964689	966075
Iter 191: InceptionV4/InceptionV4/Mixed_7d/Branch_3/AvgPool_0a_3x3/AvgPool	Pooling	OpenCL	3125	966251	969376
Iter 192: InceptionV4/InceptionV4/Mixed_7d/Branch_2/Conv2d_0c_1x3/Conv2D	Convolution	CPU	7261	964844	972105
Iter 193: InceptionV4/InceptionV4/Mixed_7d/Branch_3/Conv2d_0b_1x1/Conv2D	Convolution	OpenCL	3373	969586	972959
Iter 194: InceptionV4/InceptionV4/Mixed_7d/Branch_2/Conv2d_0d_1x3/Conv2D	Convolution	CPU	3523	972197	975720
Iter 195: InceptionV4/InceptionV4/Mixed_7d/Branch_2/Conv2d_0e_3x1/Conv2D	Convolution	CPU	3536	975830	979366
Iter 196: InceptionV4/InceptionV4/Mixed_7d/Branch_2/concat	Concat	CPU	76	979473	979549
Iter 197: InceptionV4/InceptionV4/Mixed_7d/concat	Concat	CPU	365	979591	979956
Iter 198: InceptionV4/Logits/AvgPool_1a/AvgPool	Pooling	CPU	170	980004	980174
Iter 199: InceptionV4/Logits/PreLogitsFlatten/flatten/Shape	Shape	CPU	1	980239	980240
Iter 200: InceptionV4/Logits/PreLogitsFlatten/flatten/strided_slice	StridedSlice	CPU	1	980277	980278
Iter 201: InceptionV4/Logits/PreLogitsFlatten/flatten/Reshape/shape	Pack	CPU	0	980316	980316
Iter 202: InceptionV4/Logits/AvgPool_1a/AvgPool___tr4InceptionV4/Logits/PreLogitsFlatten/flatten/Reshape	ConvertTensor	CPU	5	980354	980359
Iter 203: InceptionV4/Logits/PreLogitsFlatten/flatten/Reshape	Reshape	CPU	4	980409	980413
Iter 204: InceptionV4/Logits/Logits/MatMul	MatMul	CPU	15703	980463	996166
Iter 205: InceptionV4/Logits/Logits/BiasAdd	BinaryOp	CPU	35	996282	996317
Iter 206: InceptionV4/Logits/Predictions	Softmax	CPU	20	996358	996378
